آب انبار	آب‌انبار
آب باران	آب‌باران
آب به آب	آب‌به‌آب
آب بها	آب‌بها
آب پاش	آب‌پاش
آب پز	آب‌پز
آب تره	آب‌تره
آب جو	آبجو
آب خور	آبخور
آب خوست	آبخوست
آب دار خانه	آبدارخانه
آب دزدك	آبدزدك
آب دستان	آبدستان
آب دوغ	آبدوغ
آب دوغ خيار	آبدوغ‌خيار
آب ديده	آبديده
آب رفت	آبرفت
آب رنگ	آبرنگ
آب رو	آبرو
آب ريز	آبريز
آب زيپو	آب‌زيپو
آب زير كاه	آب‌زيركاه
آب زيركاه	آب‌زيركاه
آب سرد كن	آبسردكن
آب سردكن	آبسردكن
آب سفيد	آب‌سفيد
آب سياه	آب‌سياه
آب شش	آبشش
آب طلا	آب‌طلا
آب غوره	آبغوره
آب گرم كن	آبگرمكن
آب گرمكن	آبگرمكن
آب گز	آبگز
آب ليمو	آب‌ليمو
آب مرواريد	آب‌مرواريد
آب نبات	آب‌نبات
آب‌جو	آبجو
آب‌خور	آبخور
آب‌خوست	آبخوست
آب‌دار‌خانه	آبدارخانه
آب‌دزدك	آبدزدك
آب‌دستان	آبدستان
آب‌دوغ	آبدوغ
آب‌دوغ‌خيار	آبدوغ‌خيار
آب‌ديده	آبديده
آب‌رفت	آبرفت
آب‌رنگ	آبرنگ
آب‌رو	آبرو
آب‌ريز	آبريز
آب‌زير‌كاه	آب‌زيركاه
آب‌سرد‌كن	آبسردكن
آب‌شش	آبشش
آب‌غوره	آبغوره
آب‌گرم‌كن	آبگرمكن
آب‌گز	آبگز
آبپاش	آب‌پاش
آبپز	آب‌پز
آبدار خانه	آبدارخانه
آبدوغ خيار	آبدوغ‌خيار
آبزيپو	آب‌زيپو
آبسرد كن	آبسردكن
آبسفيد	آب‌سفيد
آبسياه	آب‌سياه
آبش خور	آبشخور
آبش‌خور	آبشخور
آبگرم كن	آبگرمكن
آبليمو	آب‌ليمو
آبمرواريد	آب‌مرواريد
آبنبات	آب‌نبات
آتش بس	آتش‌بس
آتش پاره	آتشپاره
آتش خوار	آتش‌خوار
آتش زنه	آتشزنه
آتش فشان	آتش‌فشان
آتش گردان	آتش‌گردان
آتش‌پاره	آتشپاره
آتش‌زنه	آتشزنه
آتشبس	آتش‌بس
آتشخوار	آتش‌خوار
آتشفشان	آتش‌فشان
آتشگردان	آتش‌گردان
آخر الامر	آخرالامر
آخر الزمان	آخرالزمان
آخر الزماني	آخرالزماني
آدمي زاد	آدميزاد
آدمي‌زاد	آدميزاد
آرام پز	آرام‌پز
آرامپز	آرام‌پز
آسمان خراش	آسمان‌خراش
آسمان غره	آسمان‌غره
آسمانخراش	آسمان‌خراش
آسمانغره	آسمان‌غره
آسيمه سر	آسيمه‌سر
آفتاب رو	آفتاب‌رو
آفتاب گردان	آفتاب‌گردان
آفتاب گير	آفتاب‌گير
آفتاب مهتاب	آفتاب‌مهتاب
آفتابرو	آفتاب‌رو
آفتابگردان	آفتاب‌گردان
آفتابگير	آفتاب‌گير
آل عمران	آل‌عمران
آلرژي زا	آلرژي‌زا
آمفي تئاتر	آمفي‌تئاتر
آيت ‌الله	آيت‌الله
آيت الله العظمي	آيت‌الله‌العظمي
آيت اللهي	آيت‌اللهي
آيت‌الله العظمي	آيت‌الله‌العظمي
آيه الله	آيه‌الله
ابا الفضل	اباالفضل
ابا عبد الله	اباعبدالله
اباعبد الله	اباعبدالله
ابو الاعلي	ابوالاعلي
ابو البركات	ابوالبركات
ابو البشر	ابوالبشر
ابو الحسن	ابوالحسن
ابو الحسني	ابوالحسني
ابو الخير	ابوالخير
ابو العباس	ابوالعباس
ابو العلاء	ابوالعلاء
ابو العينين	ابوالعينين
ابو الفتح	ابوالفتح
ابو الفتحي	ابوالفتحي
ابو الفتوح	ابوالفتوح
ابو الفرج	ابوالفرج
ابو الفضل	ابوالفضل
ابو الفضلي	ابوالفضلي
ابو الفوارس	ابوالفوارس
ابو القاسم	ابوالقاسم
ابو القاسمي	ابوالقاسمي
ابو المعالي	ابوالمعالي
ابو الهول	ابوالهول
ابو الوفا	ابوالوفا
ابو عبد الله	ابوعبدالله
ابوعبد الله	ابوعبدالله
ابي ‌الحديد	ابي‌الحديد
ابي ‌الصلاح	ابي‌الصلاح
ابي ‌القاسم	ابي‌القاسم
ابي‌ عبد الله	ابي‌عبدالله
ابي‌عبد الله	ابي‌عبدالله
اتقوا الله	اتقواالله
اثني عشر	اثني‌عشر
احوال پرسي	احوالپرسي
احوال‌پرسي	احوالپرسي
اخوان المسلمين	اخوان‌المسلمين
اخير الذكر	اخيرالذكر
اساطير الاولين	اساطيرالاولين
استغفر الله	استغفرالله
استقلال طلب	استقلال‌طلب
استقلال طلبان	استقلال‌طلبان
استقلال طلبانه	استقلال‌طلبانه
استقلال طلبي	استقلال‌طلبي
اسد الله	اسدالله
اسد اللهي	اسداللهي
اسرار التوحيد	اسرارالتوحيد
اشتغال زا	اشتغال‌زا
اشتغال زايي	اشتغال‌زايي
اشرف الدين	اشرف‌الدين
اشرف السلطنه	اشرف‌السلطنه
اعتضاد السلطنه	اعتضادالسلطنه
اعتماد الدوله	اعتمادالدوله
اعتماد السلطنه	اعتمادالسلطنه
افضل الدين	افضل‌الدين
الا الله	الاالله
التماس آميز	التماس‌آميز
الحمد الله	الحمدالله
الحمد لله	الحمدلله
الرحم الرحمين	الرحم‌الرحمين
السلام عليك	السلام‌عليك
الشرق الاوسط	الشرق‌الاوسط
الله اكبر	الله‌اكبر
الهام بخش	الهام‌بخش
الهام گيري	الهام‌گيري
امر الله	امرالله
امر اللهي	امراللهي
امير المؤمنين	اميرالمؤمنين
امين الدين	امين‌الدين
امين السلطنه	امين‌السلطنه
امين الملك	امين‌الملك
امين‌ الدوله	امين‌الدوله
إن شاءالله	ان‌شاءالله
إن شاء الله	ان‌شاءالله
إن‌شاء الله	ان‌شاءالله
إن شاءلله	ان‌شاءالله
إن شاء لله	ان‌شاءالله
إن‌شاء لله	ان‌شاءالله
إن شاالله	ان‌شاءالله
إن شا الله	ان‌شاءالله
إن‌شا الله	ان‌شاءالله
إن شالله	ان‌شاءالله
إن شا لله	ان‌شاءالله
إن‌شا لله	ان‌شاءالله
إن شاءاله	ان‌شاءالله
إن شاء اله	ان‌شاءالله
إن‌شاء اله	ان‌شاءالله
إن شاءله	ان‌شاءالله
إن شاء له	ان‌شاءالله
إن‌شاء له	ان‌شاءالله
إن شااله	ان‌شاءالله
إن شا اله	ان‌شاءالله
إن‌شا اله	ان‌شاءالله
إن شاله	ان‌شاءالله
إن شا له	ان‌شاءالله
إن‌شا له	ان‌شاءالله
ان شاءالله	ان‌شاءالله
ان شاء الله	ان‌شاءالله
ان‌شاء الله	ان‌شاءالله
ان شاءلله	ان‌شاءالله
ان شاء لله	ان‌شاءالله
ان‌شاء لله	ان‌شاءالله
ان شاالله	ان‌شاءالله
ان شا الله	ان‌شاءالله
ان‌شا الله	ان‌شاءالله
ان شالله	ان‌شاءالله
ان شا لله	ان‌شاءالله
ان‌شا لله	ان‌شاءالله
ان شاءاله	ان‌شاءالله
ان شاء اله	ان‌شاءالله
ان‌شاء اله	ان‌شاءالله
ان شاءله	ان‌شاءالله
ان شاء له	ان‌شاءالله
ان‌شاء له	ان‌شاءالله
ان شااله	ان‌شاءالله
ان شا اله	ان‌شاءالله
ان‌شا اله	ان‌شاءالله
ان شاله	ان‌شاءالله
ان شا له	ان‌شاءالله
ان‌شا له	ان‌شاءالله
إنشاء الله	ان‌شاءالله
إنشاء لله	ان‌شاءالله
إنشا الله	ان‌شاءالله
إنشا لله	ان‌شاءالله
إنشاء اله	ان‌شاءالله
إنشاء له	ان‌شاءالله
إنشا اله	ان‌شاءالله
إنشا له	ان‌شاءالله
انشاء الله	ان‌شاءالله
انشاء لله	ان‌شاءالله
انشا الله	ان‌شاءالله
انشا لله	ان‌شاءالله
انشاء اله	ان‌شاءالله
انشاء له	ان‌شاءالله
انشا اله	ان‌شاءالله
انشا له	ان‌شاءالله
انا الحق	اناالحق
انيس الدوله	انيس‌الدوله
اور كت	اوركت
اور‌كت	اوركت
اولو العزم	اولوالعزم
اولي الامر	اولي‌الامر
اولياء الله	اولياءالله
بارك الله	بارك‌الله
باري تعالي	باري‌تعالي
باقر العلوم	باقرالعلوم
بحر العلوم	بحرالعلوم
بحر العلومي	بحرالعلومي
بحر الميت	بحرالميت
بحمد الله	بحمدالله
بخور بخور	بخوربخور
بخور‌بخور	بخوربخور
بد قدم	بدقدم
بد نفس	بدنفس
بد‌قدم	بدقدم
بد‌نفس	بدنفس
بدر الدين	بدرالدين
بدر الزمان	بدرالزمان
برهان الدين	برهان‌الدين
بزرگ سال	بزرگسال
بزرگ‌سال	بزرگسال
بزن بزن	بزن‌بزن
بزن بهادر	بزن‌بهادر
بزن و بكوب	بزن‌و‌بكوب
بزن وبكوب	بزن‌و‌بكوب
بسم الله	بسم‌الله
بسم الله الرحمن الرحيم	بسم‌الله‌الرحمن‌الرحيم
بسم الله الرحمن‌الرحيم	بسم‌الله‌الرحمن‌الرحيم
بسم الله‌الرحمن الرحيم	بسم‌الله‌الرحمن‌الرحيم
بسم الله‌الرحمن‌الرحيم	بسم‌الله‌الرحمن‌الرحيم
بسم‌الله الرحمن الرحيم	بسم‌الله‌الرحمن‌الرحيم
بسم‌الله الرحمن‌الرحيم	بسم‌الله‌الرحمن‌الرحيم
بسم‌الله‌الرحمن الرحيم	بسم‌الله‌الرحمن‌الرحيم
بسمه تعالي	بسمه‌تعالي
بصل النخاع	بصل‌النخاع
بقية الله	بقيةالله
بك تاش	بكتاش
بك‌تاش	بكتاش
بله بران	بله‌بران
بمب افكن	بمب‌افكن
بن بست	بن‌بست
بنا گوش	بناگوش
بنا‌گوش	بناگوش
بند پايان	بندپايان
بند و بست	بندوبست
بند وبست	بندوبست
بند‌پايان	بندپايان
بند‌و‌بست	بندوبست
بندو بست	بندوبست
به الاجبار	بالاجبار
به الاخره	بالاخره
به الاخص	بالاخص
به الايمان	بالايمان
به البينات	بالبينات
به الجمله	بالجمله
به الجور	بالجور
به الحق	بالحق
به الخصوص	بالخصوص
به السويه	بالسويه
به السيف	بالسيف
به الصبر	بالصبر
به الصراحه	بالصراحه
به الضروره	بالضروره
به الطبع	بالطبع
به العباد	بالعباد
به العدل	بالعدل
به العقود	بالعقود
به العكس	بالعكس
به الفطره	بالفطره
به الفعل	بالفعل
به الفعلي	بالفعلي
به الفور	بالفور
به القسط	بالقسط
به القوة	بالقوة
به القوه	بالقوه
به القوه‌اي	بالقوه‌اي
به الكتاب	بالكتاب
به الله	بالله
به المآل	بالمآل
به المؤمنين	بالمؤمنين
به المره	بالمره
به المعروف	بالمعروف
به النتيجه	بالنتيجه
به النسبه	بالنسبه
به الهدي	بالهدي
به داشت	بهداشت
به دانه	به‌دانه
به نام	بنام
به‌الاجبار	بالاجبار
به‌الاخره	بالاخره
به‌الاخص	بالاخص
به‌الايمان	بالايمان
به‌البينات	بالبينات
به‌الجمله	بالجمله
به‌الجور	بالجور
به‌الحق	بالحق
به‌الخصوص	بالخصوص
به‌السويه	بالسويه
به‌السيف	بالسيف
به‌الصبر	بالصبر
به‌الصراحه	بالصراحه
به‌الضروره	بالضروره
به‌الطبع	بالطبع
به‌العباد	بالعباد
به‌العدل	بالعدل
به‌العقود	بالعقود
به‌العكس	بالعكس
به‌الفطره	بالفطره
به‌الفعل	بالفعل
به‌الفعلي	بالفعلي
به‌الفور	بالفور
به‌القسط	بالقسط
به‌القوة	بالقوة
به‌القوه	بالقوه
به‌القوه‌اي	بالقوه‌اي
به‌الكتاب	بالكتاب
به‌الله	بالله
به‌المآل	بالمآل
به‌المؤمنين	بالمؤمنين
به‌المره	بالمره
به‌المعروف	بالمعروف
به‌النتيجه	بالنتيجه
به‌النسبه	بالنسبه
به‌الهدي	بالهدي
به‌داشت	بهداشت
بهاء الدين	بهاءالدين
بهار نارنج	بهارنارنج
بهار‌نارنج	بهارنارنج
بهدانه	به‌دانه
بو تيمار	بوتيمار
بو مادران	بومادران
بو‌تيمار	بوتيمار
بو‌مادران	بومادران
بي بالان	بي‌بالان
بي جا	بيجا
بي چشم و رو	بي‌چشم‌و‌رو
بي چشم ورو	بي‌چشم‌و‌رو
بي حساب	بي‌حساب
بي خود	بي‌خود
بي داد	بيداد
بي دست و پا	بي‌دست‌و‌پا
بي دست وپا	بي‌دست‌و‌پا
بي دل	بيدل
بي راه	بيراه
بي رگ	بي‌رگ
بي سر و پا	بي‌سروپا
بي سر وپا	بي‌سروپا
بي سروپا	بي‌سروپا
بي سواد	بي‌سواد
بي سيم	بي‌سيم
بي طرف	بي‌طرف
بي عار	بيعار
بي كار	بيكار
بي كران	بي‌كران
بي نشان	بي‌نشان
بي نماز	بي‌نماز
بي نمك	بي‌نمك
بي نوا	بينوا
بي همال	بي‌همال
بي همتا	بي‌همتا
بي هوش	بيهوش
بي‌داد	بيداد
بي‌دل	بيدل
بي‌راه	بيراه
بي‌سر‌و‌پا	بي‌سروپا
بي‌كار	بيكار
بي‌نوا	بينوا
بي‌هوش	بيهوش
بيبالان	بي‌بالان
بيت الله	بيت‌الله
بيت المال	بيت‌المال
بيت المقدس	بيت‌المقدس
بيچشم و رو	بي‌چشم‌و‌رو
بيچشم ورو	بي‌چشم‌و‌رو
بيحساب	بي‌حساب
بيدست و پا	بي‌دست‌و‌پا
بيدست وپا	بي‌دست‌و‌پا
بيرگ	بي‌رگ
بيسر وپا	بي‌سروپا
بيسرو پا	بي‌سروپا
بيسروپا	بي‌سروپا
بيسيم	بي‌سيم
بيكران	بي‌كران
بين الاذهاني	بين‌الاذهاني
بين الدولي	بين‌الدولي
بين المجالس	بين‌المجالس
بين الملل	بين‌الملل
بين المللي	بين‌المللي
بين النهرين	بين‌النهرين
بينا بين	بينابين
بينشان	بي‌نشان
بينماز	بي‌نماز
بينمك	بي‌نمك
بيهمال	بي‌همال
بيهمتا	بي‌همتا
پا افزا	پاافزا
پا بر جا	پابرجا
پا بر سران	پابرسران
پا برجا	پابرجا
پا برسران	پابرسران
پا به ماه	پا‌به‌ماه
پا به‌ماه	پا‌به‌ماه
پا پتي	پاپتي
پا پوش	پاپوش
پا تختي	پاتختي
پا چين	پاچين
پا در هوا	پادرهوا
پا درختي	پادرختي
پا درهوا	پادرهوا
پا دو	پادو
پا شويه	پاشويه
پا نويس	پانويس
پا ياب	پاياب
پا‌افزا	پاافزا
پا‌بر‌جا	پابرجا
پا‌بر‌سران	پابرسران
پا‌پتي	پاپتي
پا‌پوش	پاپوش
پا‌تختي	پاتختي
پا‌چين	پاچين
پا‌در‌هوا	پادرهوا
پا‌درختي	پادرختي
پا‌دو	پادو
پا‌شويه	پاشويه
پا‌نويس	پانويس
پا‌ياب	پاياب
پابر جا	پابرجا
پابر سران	پابرسران
پابه ماه	پا‌به‌ماه
پابه‌ماه	پا‌به‌ماه
پاتو بيو لوژي	پاتوبيولوژي
پاتو لوژي	پاتولوژي
پاد زي	پادزي
پاد‌زي	پادزي
پادر هوا	پادرهوا
پار دم	پاردم
پار سنگ	پارسنگ
پار‌دم	پاردم
پار‌سنگ	پارسنگ
پاس دار	پاسدار
پاس‌دار	پاسدار
پاشنه كش	پاشنه‌كش
پاك باز	پاك‌باز
پاك دامن	پاك‌دامن
پاك دل	پاك‌دل
پاك سرشت	پاك‌سرشت
پاك نهاد	پاك‌نهاد
پاك نويس	پاك‌نويس
پاكباز	پاك‌باز
پاكدامن	پاك‌دامن
پاكدل	پاك‌دل
پاكسرشت	پاك‌سرشت
پاكنهاد	پاك‌نهاد
پاكنويس	پاك‌نويس
پاي بست	پاي‌بست
پاي بند	پايبند
پاي تخت	پايتخت
پاي‌بند	پايبند
پاي‌تخت	پايتخت
پايا پاي	پاياپاي
پايان نامه	پايان‌نامه
پايبست	پاي‌بست
پدر سگ	پدرسگ
پدر سوخته	پدرسوخته
پدر مرده	پدرمرده
پدر‌سگ	پدرسگ
پدر‌سوخته	پدرسوخته
پدر‌مرده	پدرمرده
پر پشت	پرپشت
پر چانه	پرچانه
پر دل	پردل
پر رو	پررو
پر مدعا	پرمدعا
پر و پا قرص	پروپاقرص
پر و پاقرص	پروپاقرص
پر و پيمان	پر‌و‌پيمان
پر وپا قرص	پروپاقرص
پر وپيمان	پر‌و‌پيمان
پر‌پشت	پرپشت
پر‌چانه	پرچانه
پر‌دل	پردل
پر‌رو	پررو
پر‌مدعا	پرمدعا
پر‌و‌پا‌قرص	پروپاقرص
پرتو بيني	پرتوبيني
پرتو شناسي	پرتوشناسي
پرتو‌بيني	پرتوبيني
پرتو‌شناسي	پرتوشناسي
پرده دار	پرده‌دار
پرسش نامه	پرسش‌نامه
پرسشنامه	پرسش‌نامه
پرو پا قرص	پروپاقرص
پرو پيمان	پر‌و‌پيمان
پروپا قرص	پروپاقرص
پروپيمان	پر‌و‌پيمان
پري پيكر	پري‌پيكر
پري چهر	پري‌چهر
پري رو	پري‌رو
پريپيكر	پري‌پيكر
پريچهر	پري‌چهر
پريرو	پري‌رو
پزشك يار	پزشكيار
پزشك‌يار	پزشكيار
پس انداز	پس‌انداز
پس اوند	پساوند
پس تو	پستو
پس‌تو	پستو
پست خانه	پستخانه
پشت بام	پشت‌بام
پشت بلند	پشت‌بلند
پشت پا	پشت‌پا
پشت پرده	پشت‌پرده
پشت دري	پشت‌دري
پشت دستي	پشت‌دستي
پشت سر	پشت‌سر
پشت كار	پشتكار
پشت گردن	پشت‌گردن
پشت گردني	پشت‌گردني
پشت گوش	پشت‌گوش
پشت‌كار	پشتكار
پشتبام	پشت‌بام
پشتبلند	پشت‌بلند
پشتپا	پشت‌پا
پشتپرده	پشت‌پرده
پشتدري	پشت‌دري
پشتدستي	پشت‌دستي
پشتسر	پشت‌سر
پشتگردن	پشت‌گردن
پشتگردني	پشت‌گردني
پشتگوش	پشت‌گوش
پلي تكنيك	پلي‌تكنيك
پنبه دانه	پنبه‌دانه
پنج شنبه	پنجشنبه
پنج گاه	پنج‌گاه
پنج‌شنبه	پنجشنبه
پنجگاه	پنج‌گاه
پوست كلفت	پوست‌كلفت
پوستكلفت	پوست‌كلفت
پياده رو	پياده‌رو
پيچ گوشتي	پيچ‌گوشتي
پيچگوشتي	پيچ‌گوشتي
پيدا زادان	پيدازادان
پيدا‌زادان	پيدازادان
پيش اب	پيشاب
پيش اب راه	پيشاب‌راه
پيش ابراه	پيشاب‌راه
پيش امد	پيشامد
پيش اهنگ	پيشاهنگ
پيش بند	پيش‌بند
پيش بها	پيش‌بها
پيش پرداخت	پيش‌پرداخت
پيش خدمت	پيشخدمت
پيش خوان	پيشخوان
پيش فنگ	پيش‌فنگ
پيش قدم	پيش‌قدم
پيش قراول	پيش‌قراول
پيش قسط	پيش‌قسط
پيش كسوت	پيش‌كسوت
پيش مرگ	پيش‌مرگ
پيش نماز	پيش‌نماز
پيش نهاد	پيشنهاد
پيش نويس	پيش‌نويس
پيش‌اب	پيشاب
پيش‌اب‌راه	پيشاب‌راه
پيش‌امد	پيشامد
پيش‌اهنگ	پيشاهنگ
پيش‌خدمت	پيشخدمت
پيش‌خوان	پيشخوان
پيش‌نهاد	پيشنهاد
پيشاب راه	پيشاب‌راه
پيشابراه	پيشاب‌راه
پيشبند	پيش‌بند
پيشبها	پيش‌بها
پيشپرداخت	پيش‌پرداخت
پيشفنگ	پيش‌فنگ
پيشقدم	پيش‌قدم
پيشكسوت	پيش‌كسوت
پيشمرگ	پيش‌مرگ
پيشنماز	پيش‌نماز
پيشنويس	پيش‌نويس
پيل بان	پيلبان
پيل‌بان	پيلبان
پيه سوز	پيه‌سوز
تاج الدين	تاج‌الدين
تاج خروس	تاج‌خروس
تاجخروس	تاج‌خروس
تار آوا	تارآوا
تار تن	تارتن
تار و پود	تاروپود
تار وپود	تاروپود
تار‌آوا	تارآوا
تار‌تن	تارتن
تار‌و‌پود	تاروپود
تارو پود	تاروپود
تاريك خانه	تاريك‌خانه
تاريكخانه	تاريك‌خانه
تاژك داران	تاژك‌داران
تاژكداران	تاژك‌داران
تاق ديس	تاقديس
تاق‌ديس	تاقديس
تام الاختيار	تام‌الاختيار
تب خال	تب‌خال
تبخال	تب‌خال
تبر زين	تبرزين
تبر‌زين	تبرزين
تحت الشعاع	تحت‌الشعاع
تحت اللفظي	تحت‌اللفظي
تحرير الوسيله	تحريرالوسيله
تحف العقول	تحف‌العقول
تخته بند	تخته‌بند
تخم مرغ	تخم‌مرغ
تر تيزك	ترتيزك
تر‌تيزك	ترتيزك
تراز نامه	ترازنامه
تراز‌نامه	ترازنامه
ترجيع بند	ترجيع‌بند
تركيب بند	تركيب‌بند
تره بار	تره‌بار
تقي الدين	تقي‌الدين
تك لپه	تك‌لپه
تك واژ	تكواژ
تك ياخته	تك‌ياخته
تك‌واژ	تكواژ
تكياخته	تك‌ياخته
تلفن گرام	تلفن‌گرام
تلفنگرام	تلفن‌گرام
تله پاتي	تله‌پاتي
تله تايپ	تله‌تايپ
تله فاكس	تله‌فاكس
تله كابين	تله‌كابين
تلو تلو	تلوتلو
تلو‌تلو	تلوتلو
تمام رخ	تمام‌رخ
تمامرخ	تمام‌رخ
تن پوش	تن‌پوش
تن خواه	تنخواه
تن دوست	تن‌دوست
تن ديس	تنديس
تن‌خواه	تنخواه
تن‌ديس	تنديس
تنپوش	تن‌پوش
تند باد	تندباد
تند خو	تندخو
تند‌باد	تندباد
تند‌خو	تندخو
تندوست	تن‌دوست
تنگ چشم	تنگ‌چشم
تنگ دست	تنگ‌دست
تنگ دل	تنگدل
تنگ‌دل	تنگدل
تنگا تنگ	تنگاتنگ
تنگچشم	تنگ‌چشم
تنگدست	تنگ‌دست
ته تغاري	ته‌تغاري
ته چين	ته‌چين
ته ديگ	ته‌ديگ
ته ريش	ته‌ريش
ته نشين	ته‌نشين
تهي دست	تهيدست
تهي‌دست	تهيدست
تير آهن	تيرآهن
تير بار	تيربار
تير باران	تيرباران
تير رس	تيررس
تير كمان	تيركمان
تير‌آهن	تيرآهن
تير‌بار	تيربار
تير‌باران	تيرباران
تير‌رس	تيررس
تير‌كمان	تيركمان
تيز آب	تيزاب
تيز‌آب	تيزاب
ثار الله	ثارالله
ثامن الائمه	ثامن‌الائمه
ثقة الاسلام	ثقةالاسلام
جا رختي	جارختي
جا رو	جارو
جا نماز	جانماز
جا‌رختي	جارختي
جا‌نماز	جانماز
جابر بن	جابربن
جابر بن‌ حيان	جابربن‌حيان
جابر بن‌ عبد الله	جابربن‌عبدالله
جابر بن‌ عبدالله	جابربن‌عبدالله
جابر بن‌حيان	جابربن‌حيان
جابر بن‌عبد الله	جابربن‌عبدالله
جابر بن‌عبدالله	جابربن‌عبدالله
جابربن‌ حيان	جابربن‌حيان
جابربن‌ عبد الله	جابربن‌عبدالله
جابربن‌ عبدالله	جابربن‌عبدالله
جابربن‌عبد الله	جابربن‌عبدالله
جاده صاف كن	جاده‌صاف‌كن
جاده صاف‌كن	جاده‌صاف‌كن
جاده صافكن	جاده‌صاف‌كن
جاده‌صاف كن	جاده‌صاف‌كن
جامع الشرايط	جامع‌الشرايط
جامعه شناس	جامعه‌شناس
جان پناه	جان‌پناه
جان دارو	جان‌دارو
جان سخت	جان‌سخت
جانپناه	جان‌پناه
جاندارو	جان‌دارو
جانسخت	جان‌سخت
جبل الطارق	جبل‌الطارق
جدا گلبرگ	جداگلبرگ
جدا‌گلبرگ	جداگلبرگ
جديد الاحداث	جديدالاحداث
جديد التأسيس	جديدالتأسيس
جديد التأليف	جديدالتأليف
جفا پيشه	جفاپيشه
جفا كش	جفاكش
جفا‌پيشه	جفاپيشه
جفا‌كش	جفاكش
جگر سفيد	جگرسفيد
جگر گوشه	جگرگوشه
جگر‌سفيد	جگرسفيد
جگر‌گوشه	جگرگوشه
جلال الدين	جلال‌الدين
جلو خان	جلوخان
جلو دار	جلودار
جلو‌خان	جلوخان
جلو‌دار	جلودار
جمادي الاخر	جمادي‌الاخر
جمادي الثاني	جمادي‌الثاني
جمال الدين	جمال‌الدين
جهان ديده	جهان‌ديده
جهان وطني	جهان‌وطني
جهانديده	جهان‌ديده
جهانوطني	جهان‌وطني
جوال دوز	جوال‌دوز
جوالدوز	جوال‌دوز
جوان بخت	جوان‌بخت
جوان مرد	جوانمرد
جوان مرگ	جوان‌مرگ
جوان‌مرد	جوانمرد
جوانبخت	جوان‌بخت
جوانمرگ	جوان‌مرگ
جوجه تيغي	جوجه‌تيغي
جوش شيرين	جوش‌شيرين
چاپ خانه	چاپخانه
چاپ‌خانه	چاپخانه
چار قد	چارقد
چار‌قد	چارقد
چپ گرا	چپ‌گرا
چپ نما	چپ‌نما
چپگرا	چپ‌گرا
چپنما	چپ‌نما
چرب زبان	چرب‌زبان
چرب زباني	چرب‌زباني
چربزبان	چرب‌زبان
چربزباني	چرب‌زباني
چرخ ريسك	چرخ‌ريسك
چرخريسك	چرخ‌ريسك
چرك نويس	چرك‌نويس
چركنويس	چرك‌نويس
چشم بلبلي	چشم‌بلبلي
چشم تنگ	چشم‌تنگ
چشم خانه	چشم‌خانه
چشم روشني	چشم‌روشني
چشم زخم	چشم‌زخم
چشم زهره	چشم‌زهره
چشم سفيد	چشم‌سفيد
چشم شور	چشم‌شور
چشم غره	چشم‌غره
چشم ينام	چشم‌ينام
چشمتنگ	چشم‌تنگ
چشمخانه	چشم‌خانه
چشمروشني	چشم‌روشني
چشمزخم	چشم‌زخم
چشمزهره	چشم‌زهره
چشمسفيد	چشم‌سفيد
چشمشور	چشم‌شور
چشمغره	چشم‌غره
چشمينام	چشم‌ينام
چلو كباب	چلوكباب
چلو كبابي	چلوكبابي
چلو‌كباب	چلوكباب
چلو‌كبابي	چلوكبابي
چمن آرا	چمن‌آرا
چمنارا	چمن‌آرا
چند بر	چندبر
چند‌بر	چندبر
چهار ديوار	چهارديوار
چهار راه	چهارراه
چهار زانو	چهارزانو
چهار سوق	چهارسوق
چهار شاق	چهارشاق
چهار شانه	چهارشانه
چهار شنبه	چهارشنبه
چهار طاق	چهارطاق
چهار گاه	چهارگاه
چهار گل	چهارگل
چهار گوش	چهارگوش
چهار مضراب	چهارمضراب
چهار ميخ	چهارميخ
چهار نعل	چهارنعل
چهار‌ديوار	چهارديوار
چهار‌راه	چهارراه
چهار‌زانو	چهارزانو
چهار‌سوق	چهارسوق
چهار‌شاق	چهارشاق
چهار‌شانه	چهارشانه
چهار‌شنبه	چهارشنبه
چهار‌طاق	چهارطاق
چهار‌گاه	چهارگاه
چهار‌گل	چهارگل
چهار‌گوش	چهارگوش
چهار‌مضراب	چهارمضراب
چهار‌ميخ	چهارميخ
چهار‌نعل	چهارنعل
چهل چراغ	چهل‌چراغ
چهلچراغ	چهل‌چراغ
چوب بست	چوب‌بست
چوب پنبه	چوب‌پنبه
چوب دست	چوب‌دست
چوب رختي	چوب‌رختي
چوبپنبه	چوب‌پنبه
چوبدست	چوب‌دست
چوبرختي	چوب‌رختي
حاج حسيني	حاج‌حسيني
حاجي بادام	حاجي‌بادام
حاجي فيروز	حاجي‌فيروز
حاجي لك لك	حاجي‌لك‌لك
حاجي لكلك	حاجي‌لك‌لك
حاجي‌لك لك	حاجي‌لك‌لك
حبل الله	حبل‌الله
حبيب الله	حبيب‌الله
حتي الامكان	حتي‌الامكان
حتي المقدور	حتي‌المقدور
حجة الوداع	حجةالوداع
حجت الاسلام	حجت‌الاسلام
حجت الاسلام و المسلمين	حجت‌الاسلام‌والمسلمين
حجت الاسلام والمسلمين	حجت‌الاسلام‌والمسلمين
حجت الاسلام‌و المسلمين	حجت‌الاسلام‌والمسلمين
حجت الاسلام‌والمسلمين	حجت‌الاسلام‌والمسلمين
حجت الله	حجت‌الله
حجت‌الاسلام و المسلمين	حجت‌الاسلام‌والمسلمين
حجت‌الاسلام والمسلمين	حجت‌الاسلام‌والمسلمين
حجت‌الاسلام‌و المسلمين	حجت‌الاسلام‌والمسلمين
حجر الأسود	حجرالأسود
حجر بن عدي	حجربن‌عدي
حجر بن‌عدي	حجربن‌عدي
حجربن عدي	حجربن‌عدي
حرام زاده	حرام‌زاده
حرامزاده	حرام‌زاده
حرم سرا	حرم‌سرا
حرمسرا	حرم‌سرا
حزب الله	حزب‌الله
حزب اللهي	حزب‌اللهي
حسام الدين	حسام‌الدين
حشره خواران	حشره‌خواران
حشمت الله	حشمت‌الله
حق الامتياز	حق‌الامتياز
حق التدريس	حق‌التدريس
حق الثبت	حق‌الثبت
حق الزحمه	حق‌الزحمه
حق العمل	حق‌العمل
حق الله	حق‌الله
حق الناس	حق‌الناس
حكم الله	حكم‌الله
حكيم الممالك	حكيم‌الممالك
حلال زاده	حلال‌زاده
حلالزاده	حلال‌زاده
حمد الله	حمدالله
حور العين	حورالعين
حور‌العين	حورالعين
خاتم الانبيا	خاتم‌الانبيا
خار بن	خاربن
خار پشت	خارپشت
خار پوست	خارپوست
خار خسك	خارخسك
خار شتر	خارشتر
خار‌بن	خاربن
خار‌پشت	خارپشت
خار‌پوست	خارپوست
خار‌خسك	خارخسك
خار‌شتر	خارشتر
خارق العاده	خارق‌العاده
خارق العاده‌اي	خارق‌العاده‌اي
خاطر جمع	خاطرجمع
خاطر نشان	خاطرنشان
خاطر‌جمع	خاطرجمع
خاطر‌نشان	خاطرنشان
خاك انداز	خاك‌انداز
خاك بر سر	خاك‌برسر
خاك تو سر	خاك‌توسر
خاك توسر	خاك‌توسر
خاك رو به	خاك‌رو‌به
خاك روبه	خاك‌رو‌به
خاكبرسر	خاك‌برسر
خاكتوسر	خاك‌توسر
خاكروبه	خاك‌رو‌به
خال دار	خال‌دار
خالد بن وليد	خالدبن‌وليد
خالد بن‌وليد	خالدبن‌وليد
خالدار	خال‌دار
خالدبن وليد	خالدبن‌وليد
خانه بر انداز	خانه‌برانداز
خانه برانداز	خانه‌برانداز
خانه به دوش	خانه‌به‌دوش
خانه به‌دوش	خانه‌به‌دوش
خانه خدا	خانه‌خدا
خانه دار	خانه‌دار
خانه شاگرد	خانه‌شاگرد
خانه مان	خانمان
خبر نگار	خبرنگار
خبر‌نگار	خبرنگار
ختنه سوران	ختنه‌سوران
خدا بيامرز	خدابيامرز
خدا‌بيامرز	خدابيامرز
خر پا	خرپا
خر پول	خرپول
خر تو خر	خرتوخر
خر چال	خرچال
خر چنگ	خرچنگ
خر خاكي	خرخاكي
خر زهره	خرزهره
خر گوش	خرگوش
خر مگس	خرمگس
خر مهره	خرمهره
خر‌پا	خرپا
خر‌پول	خرپول
خر‌تو‌خر	خرتوخر
خر‌چال	خرچال
خر‌چنگ	خرچنگ
خر‌خاكي	خرخاكي
خر‌زهره	خرزهره
خر‌گوش	خرگوش
خر‌مگس	خرمگس
خر‌مهره	خرمهره
خراب آباد	خراب‌آباد
خرت و پرت	خرت‌و‌پرت
خرد سال	خردسال
خرد‌سال	خردسال
خرده ريز	خرده‌ريز
خرده فرمايش	خرده‌فرمايش
خرده مالك	خرده‌مالك
خلق الله	خلق‌الله
خليفة الله	خليفةالله
خم خانه	خمخانه
خم‌خانه	خمخانه
خمير مايه	خميرمايه
خمير‌مايه	خميرمايه
خواب آور	خواب‌آور
خوار و بار	خواروبار
خوار‌و‌بار	خواروبار
خود راي	خودرأي
خود سر	خودسر
خود كار	خودكار
خود كامه	خودكامه
خود مختار	خودمختار
خود مدار	خودمدار
خود نويس	خودنويس
خود‌راي	خودرأي
خود‌سر	خودسر
خود‌كار	خودكار
خود‌كامه	خودكامه
خود‌مختار	خودمختار
خود‌مدار	خودمدار
خود‌نويس	خودنويس
خودراي	خودرأي
خوش اخلاق	خوش‌اخلاق
خوش بخت	خوشبخت
خوش بو	خوشبو
خوش بوي	خوشبوي
خوش حال	خوشحال
خوش خو	خوش‌خو
خوش خوي	خوش‌خوي
خوش رو	خوش‌رو
خوش روي	خوش‌روي
خوش گل	خوشگل
خوش مزه	خوشمزه
خوش‌‌حال	خوشحال
خوش‌بخت	خوشبخت
خوش‌بو	خوشبو
خوش‌بوي	خوشبوي
خوش‌گل	خوشگل
خوش‌مزه	خوشمزه
خوشخو	خوش‌خو
خوشخوي	خوش‌خوي
خوشرو	خوش‌رو
خوشروي	خوش‌روي
خون آبه	خونابه
خون آشام	خون‌آشام
خون بها	خون‌بها
خون سرد	خونسرد
خون گرم	خونگرم
خون‌آبه	خونابه
خون‌سرد	خونسرد
خون‌گرم	خونگرم
خوناشام	خون‌آشام
خونبها	خون‌بها
خير الله	خيرالله
خيره سر	خيره‌سر
خيمه شب بازي	خيمه‌شب‌بازي
دائرة المعارف	دائرةالمعارف
دائره المعارف	دائره‌المعارف
داد يار	داديار
داد‌يار	داديار
دار الأماره	دارالأماره
دار الاحياء	دارالاحياء
دار الاسلام	دارالاسلام
دار التقريب	دارالتقريب
دار الحكومه	دارالحكومه
دار الخلافه	دارالخلافه
دار السلام	دارالسلام
دار الشفا	دارالشفا
دار الشفاي	دارالشفاي
دار العلم	دارالعلم
دار الفنون	دارالفنون
دار القرآن	دارالقرآن
دار الكتب	دارالكتب
دار المعارف	دارالمعارف
دار المعلمين	دارالمعلمين
دار الندوه	دارالندوه
دار الهجره	دارالهجره
دار بست	داربست
دار كوب	داركوب
دار‌بست	داربست
دار‌كوب	داركوب
دارو خانه	داروخانه
دارو ساز	داروساز
دارو‌خانه	داروخانه
دارو‌ساز	داروساز
داغ سر	داغ‌سر
داغسر	داغ‌سر
دام پزشك	دام‌پزشك
دام يار	داميار
دام‌يار	داميار
دامپزشك	دام‌پزشك
دانش سرا	دانشسرا
دانش‌سرا	دانشسرا
دايرة المعارف‌ها	دايرةالمعارف‌ها
دايره المعارف	دايره‌المعارف
در آمد	درآمد
در بار	دربار
در به در	دربدر
در دانه	دردانه
در كل	دركل
در گير	درگير
در هم	درهم
در‌آمد	درآمد
در‌بار	دربار
در‌به‌در	دربدر
در‌گير	درگير
در‌هم	درهم
درجه دار	درجه‌دار
درر الكلم	دررالكلم
درشت ني	درشت‌ني
دريا دل	دريادل
دريا سالار	درياسالار
دريا‌دل	دريادل
دريا‌سالار	درياسالار
دست آويز	دستاويز
دست افزار	دست‌افزار
دست انداز	دست‌انداز
دست بند	دستبند
دست تنگ	دست‌تنگ
دست تنها	دست‌تنها
دست چين	دست‌چين
دست خوش	دستخوش
دست رنج	دسترنج
دست كش	دستكش
دست گيره	دستگيره
دست مال	دستمال
دست مايه	دست‌مايه
دست مزد	دستمزد
دست موزه	دست‌موزه
دست نماز	دست‌نماز
دست نويس	دست‌نويس
دست‌آويز	دستاويز
دست‌بند	دستبند
دست‌خوش	دستخوش
دست‌رنج	دسترنج
دست‌كش	دستكش
دست‌گيره	دستگيره
دست‌مال	دستمال
دست‌مزد	دستمزد
دستافزار	دست‌افزار
دستانداز	دست‌انداز
دستتتنها	دست‌تنها
دستتنگ	دست‌تنگ
دستچين	دست‌چين
دستمايه	دست‌مايه
دستنماز	دست‌نماز
دستنويس	دست‌نويس
دستور العمل	دستورالعمل
دستور العمل ها	دستورالعمل‌ها
دستور العمل هاي	دستورالعمل‌هاي
دستور العمل هايي	دستورالعمل‌هايي
دستور العمل‌ها	دستورالعمل‌ها
دستور العمل‌هاي	دستورالعمل‌هاي
دستور العمل‌هايي	دستورالعمل‌هايي
دستور العملي	دستورالعملي
دستورالعمل ها	دستورالعمل‌ها
دستورالعمل هاي	دستورالعمل‌هاي
دستورالعمل هايي	دستورالعمل‌هايي
دل آرام	دلارام
دل آزرده	دل‌آزرده
دل آكنده	دل‌آكنده
دل آور	دلاور
دل افگار	دل‌افگار
دل باخته	دل‌باخته
دل باز	دلباز
دل بند	دلبند
دل پيچه	دل‌پيچه
دل تنگ	دلتنگ
دل چركين	دل‌چركين
دل خسته	دل‌خسته
دل خواه	دلخواه
دل خور	دلخور
دل خوش	دلخوش
دل دار	دلدار
دل درد	دل‌درد
دل رحم	دل‌رحم
دل زنده	دل‌زنده
دل سرد	دلسرد
دل سياه	دل‌سياه
دل شاد	دلشاد
دل گرم	دلگرم
دل مرده	دل‌مرده
دل نهاد	دل‌نهاد
دل وا پس	دلواپس
دل‌آرام	دلارام
دل‌آور	دلاور
دل‌باز	دلباز
دل‌بند	دلبند
دل‌تنگ	دلتنگ
دل‌خواه	دلخواه
دل‌خور	دلخور
دل‌خوش	دلخوش
دل‌دار	دلدار
دل‌سرد	دلسرد
دل‌شاد	دلشاد
دل‌گرم	دلگرم
دل‌وا‌پس	دلواپس
دل‌واپس	دلواپس
دلباخته	دل‌باخته
دلپيچه	دل‌پيچه
دلچركين	دل‌چركين
دلخسته	دل‌خسته
دلدرد	دل‌درد
دلرحم	دل‌رحم
دلزنده	دل‌زنده
دلسياه	دل‌سياه
دلمرده	دل‌مرده
دلنهاد	دل‌نهاد
دم اسب	دم‌اسب
دم اسبيان	دم‌اسبيان
دم برگ	دمبرگ
دم پايي	دمپايي
دم پختك	دم‌پختك
دم كني	دم‌كني
دم‌برگ	دمبرگ
دم‌پايي	دمپايي
دماغ سوخته	دماغ‌سوخته
دمپختك	دم‌پختك
دمكني	دم‌كني
دندان پزشك	دندان‌پزشك
دندان قروچه	دندان‌قروچه
دندان گرد	دندان‌گرد
دندانپزشك	دندان‌پزشك
دنيا دوست	دنيادوست
دنيا‌دوست	دنيادوست
دهان بند	دهان‌بند
دهان بين	دهان‌بين
دهان دره	دهان‌دره
دهانبند	دهان‌بند
دهانبين	دهان‌بين
دهاندره	دهان‌دره
دو آتشه	دوآتشه
دو اسبه	دواسبه
دو چرخه	دوچرخه
دو رگه	دورگه
دو رو	دورو
دو زيستان	دوزيستان
دو قلو	دوقلو
دو كفه ايها	دوكفه‌ايها
دو كفه‌ايها	دوكفه‌ايها
دو لا	دولا
دو لپه	دولپه
دو‌آتشه	دوآتشه
دو‌اسبه	دواسبه
دو‌چرخه	دوچرخه
دو‌رگه	دورگه
دو‌رو	دورو
دو‌زيستان	دوزيستان
دو‌قلو	دوقلو
دو‌لا	دولا
دو‌لپه	دولپه
دور دست	دوردست
دور نما	دورنما
دور‌دست	دوردست
دور‌نما	دورنما
دوش آبه	دوشابه
دوش‌آبه	دوشابه
دوغ آب	دوغاب
دوغ‌آب	دوغاب
دوكفه ايها	دوكفه‌ايها
ديرين شناس	ديرين‌شناس
ديگر گون	ديگرگون
ديگر‌گون	ديگرگون
ذات الريه	ذات‌الريه
ذبيح الله	ذبيح‌الله
ذكاء الملك	ذكاءالملك
ذكر الله	ذكرالله
ذو الجلال	ذوالجلال
ذو الجناح	ذوالجناح
ذو الحق	ذوالحق
ذو الفقار	ذوالفقار
ذو الفقارنسب	ذوالفقارنسب
ذو الفقاري	ذوالفقاري
ذو الفنون	ذوالفنون
ذو القدر	ذوالقدر
ذو القرنين	ذوالقرنين
ذو النور	ذوالنور
ذو النون	ذوالنون
ذي حجه	ذي‌حجه
ذي قعده	ذي‌قعده
ذيحجه	ذي‌حجه
ذيقعده	ذي‌قعده
رئيس الوزرا	رئيس‌الوزرا
راديو اكتيو	راديواكتيو
راديو تراپي	راديوتراپي
راديو سكوپي	راديوسكوپي
راديو گرافي	راديوگرافي
راديو لوژي	راديولوژي
راديو‌اكتيو	راديواكتيو
راديو‌تراپي	راديوتراپي
راديو‌گرافي	راديوگرافي
راديو‌لوژي	راديولوژي
راست بالان	راست‌بالان
راست پنجگاه	راست‌پنجگاه
راست روده	راست‌روده
راست گرا	راست‌گرا
راست مضراب	راست‌مضراب
راستا حسيني	راستاحسيني
راستا‌حسيني	راستاحسيني
راستپنجگاه	راست‌پنجگاه
راستروده	راست‌روده
راستگرا	راست‌گرا
راستمضراب	راست‌مضراب
رام الله	رام‌الله
راه آهن	راه‌آهن
راه نمون	راهنمون
راه‌نمون	راهنمون
رب النوع	رب‌النوع
ربيع الاول	ربيع‌الاول
ربيع الثاني	ربيع‌الثاني
رحمة الله	رحمةالله
رحمت الله	رحمت‌الله
رحمت الله عليه	رحمت‌الله‌عليه
رحمت الله‌عليه	رحمت‌الله‌عليه
رحمت‌الله عليه	رحمت‌الله‌عليه
رحمه الله	رحمه‌الله
رحمه الله عليه	رحمه‌الله‌عليه
رحمه الله‌عليه	رحمه‌الله‌عليه
رحمه‌الله‌ عليه	رحمه‌الله‌عليه
رخت خواب	رختخواب
رخت كن	رختكن
رخت‌خواب	رختخواب
رخت‌كن	رختكن
رزم ناو	رزم‌ناو
رزمناو	رزم‌ناو
رستا خيز	رستاخيز
رستا‌خيز	رستاخيز
رسم الخط	رسم‌الخط
رسول الله	رسول‌الله
رشيد الدين	رشيدالدين
رصد خانه	رصدخانه
رصد‌خانه	رصدخانه
رضايت نامه	رضايت‌نامه
رضايتنامه	رضايت‌نامه
رضوان الله تعالي عليه	رضوان‌الله‌تعالي‌عليه
رضوان الله تعالي‌عليه	رضوان‌الله‌تعالي‌عليه
رضوان الله عليه	رضوان‌الله‌عليه
رضوان الله‌تعالي عليه	رضوان‌الله‌تعالي‌عليه
رضوان الله‌تعالي‌عليه	رضوان‌الله‌تعالي‌عليه
رضوان الله‌عليه	رضوان‌الله‌عليه
رضوان‌الله تعالي عليه	رضوان‌الله‌تعالي‌عليه
رضوان‌الله تعالي‌عليه	رضوان‌الله‌تعالي‌عليه
رضوان‌الله عليه	رضوان‌الله‌عليه
رضوان‌الله‌تعالي عليه	رضوان‌الله‌تعالي‌عليه
رضي الدين	رضي‌الدين
رضي الله	رضي‌الله
ركن الدوله	ركن‌الدوله
ركن الدين	ركن‌الدين
رگ بار	رگبار
رگ بالان	رگ‌بالان
رگ‌بار	رگبار
رگبالان	رگ‌بالان
رنگ و روغن	رنگ‌وروغن
رنگ وروغن	رنگ‌وروغن
رنگا رنگ	رنگارنگ
رنگا‌رنگ	رنگارنگ
رنگين كمان	رنگين‌كمان
ره آورد	ره‌آورد
رو انداز	روانداز
رو باز	روباز
رو بالش	روبالش
رو بنا	روبنا
رو به راه	روبه‌راه
رو پوست	روپوست
رو تختي	روتختي
رو دار	رودار
رو دل	رودل
رو رو	رورو
رو روك	روروك
رو سپيد	روسپيد
رو سري	روسري
رو سفيد	روسفيد
رو سياه	روسياه
رو كار	روكار
رو نوشت	رونوشت
رو‌انداز	روانداز
رو‌باز	روباز
رو‌بالش	روبالش
رو‌بنا	روبنا
رو‌پوست	روپوست
رو‌تختي	روتختي
رو‌دار	رودار
رو‌دل	رودل
رو‌رو	رورو
رو‌روك	روروك
رو‌سپيد	روسپيد
رو‌سري	روسري
رو‌سفيد	روسفيد
رو‌سياه	روسياه
رو‌كار	روكار
رو‌نوشت	رونوشت
روان كاو	روانكاو
روان‌كاو	روانكاو
روبه راه	روبه‌راه
روح القدس	روح‌القدس
روح الله	روح‌الله
رود خانه	رودخانه
رود‌خانه	رودخانه
روده دراز	روده‌دراز
روز افزون	روزافزون
روز مره	روزمره
روز نامه	روزنامه
روز‌افزون	روزافزون
روز‌مره	روزمره
روز‌نامه	روزنامه
روشن دل	روشن‌دل
روشن فكر	روشن‌فكر
روشندل	روشن‌دل
روشنفكر	روشن‌فكر
ريش بابا	ريش‌بابا
ريشه پايان	ريشه‌پايان
زائد الوصف	زائدالوصف
زايد الوصفي	زايدالوصفي
زبان آور	زبان‌آور
زبان در قفا	زبان‌درقفا
زبان دراز	زبان‌دراز
زبان شناس	زبان‌شناس
زبان گنجشك	زبان‌گنجشك
زباندراز	زبان‌دراز
زبانشناس	زبان‌شناس
زبانگنجشك	زبان‌گنجشك
زبر دست	زبردست
زبر‌دست	زبردست
زر ورق	زرورق
زر‌ورق	زرورق
زرد آب	زرداب
زرد آلو	زردآلو
زرد پوست	زردپوست
زرد پي	زردپي
زرد چوبه	زردچوبه
زرد روي	زردروي
زرد زخم	زردزخم
زرد‌آب	زرداب
زرد‌آلو	زردآلو
زرد‌پوست	زردپوست
زرد‌پي	زردپي
زرد‌چوبه	زردچوبه
زرد‌روي	زردروي
زرد‌زخم	زردزخم
زغال اخته	زغال‌اخته
زغال سنگ	زغال‌سنگ
زغالسنگ	زغال‌سنگ
زمين لرزه	زمين‌لرزه
زمينلرزه	زمين‌لرزه
زهر آبه	زهرابه
زهر چشم	زهرچشم
زهر خند	زهرخند
زهر‌ابه	زهرابه
زهر‌چشم	زهرچشم
زهر‌خند	زهرخند
زود رنج	زودرنج
زود‌رنج	زودرنج
زور خانه	زورخانه
زور‌خانه	زورخانه
زير پوست	زيرپوست
زير پيراهن	زيرپيراهن
زير چشمي	زيرچشمي
زير دريايي	زيردريايي
زير دست	زيردست
زير دستي	زيردستي
زير زمين	زيرزمين
زير شلوار	زيرشلوار
زير نويس	زيرنويس
زير‌پوست	زيرپوست
زير‌پيراهن	زيرپيراهن
زير‌چشمي	زيرچشمي
زير‌دريايي	زيردريايي
زير‌دست	زيردست
زير‌دستي	زيردستي
زير‌زمين	زيرزمين
زير‌شلوار	زيرشلوار
زير‌نويس	زيرنويس
زيست شناس	زيست‌شناس
زيستشناس	زيست‌شناس
زيگ زاگ	زيگزاگ
زيگ‌زاگ	زيگزاگ
زين الدين	زين‌الدين
زين العابدين	زين‌العابدين
سابق الذكر	سابق‌الذكر
ساده دل	ساده‌دل
ساده لوح	ساده‌لوح
ساق دوش	ساقدوش
ساق‌دوش	ساقدوش
ساقي نامه	ساقي‌نامه
ساقينامه	ساقي‌نامه
سال گرد	سالگرد
سال نامه	سالنامه
سال‌گرد	سالگرد
سال‌نامه	سالنامه
سبحان الله	سبحان‌الله
سبز انگشت	سبزانگشت
سبز خط	سبزخط
سبز قبا	سبزقبا
سبز‌انگشت	سبزانگشت
سبز‌خط	سبزخط
سبز‌قبا	سبزقبا
سبك بار	سبك‌بار
سبك بال	سبك‌بال
سبك بالان	سبك‌بالان
سبك دل	سبك‌دل
سبك روح	سبك‌روح
سبك سر	سبك‌سر
سبكبار	سبك‌بار
سبكبال	سبك‌بال
سبكبالان	سبك‌بالان
سبكدل	سبك‌دل
سبكروح	سبك‌روح
سبكسر	سبك‌سر
سپه سالار	سپهسالار
سپه‌سالار	سپهسالار
سپيده دم	سپيده‌دم
سخت پوست	سخت‌پوست
سخت جان	سخت‌جان
سخت سر	سخت‌سر
سختپوست	سخت‌پوست
سختجان	سخت‌جان
سختسر	سخت‌سر
سر آغاز	سرآغاز
سر انگشتي	سرانگشتي
سر بار	سربار
سر باز	سرباز
سر بالا	سربالا
سر براه	سربراه
سر بسته	سربسته
سر بلند	سربلند
سر بند	سربند
سر به زير	سربه‌زير
سر به مهر	سربه‌مهر
سر به هوا	سربه‌هوا
سر پاسبان	سرپاسبان
سر پرست	سرپرست
سر پنجه	سرپنجه
سر پيچ	سرپيچ
سر تيپ	سرتيپ
سر جوخه	سرجوخه
سر چشمه	سرچشمه
سر حال	سرحال
سر حد	سرحد
سر حلقه	سرحلقه
سر خر	سرخر
سر دبير	سردبير
سر در	سردر
سر در گم	سردرگم
سر درختي	سردرختي
سر درد	سردرد
سر دست	سردست
سر دسته	سردسته
سر دفتر	سردفتر
سر دوشي	سردوشي
سر راست	سرراست
سر رسيد	سررسيد
سر زمين	سرزمين
سر زنده	سرزنده
سر سبز	سرسبز
سر سخت	سرسخت
سر سرا	سرسرا
سر سره	سرسره
سر سنگين	سرسنگين
سر سيلندر	سرسيلندر
سر شاخ	سرشاخ
سر شناس	سرشناس
سر شو	سرشو
سر شير	سرشير
سر غليان	سرغليان
سر قفلي	سرقفلي
سر كتاب	سركتاب
سر كج	سركج
سر كرده	سركرده
سر كلانتر	سركلانتر
سر كنسول	سركنسول
سر كوفت	سركوفت
سر گرد	سرگرد
سر گردان	سرگردان
سر گرم	سرگرم
سر گروهبان	سرگروهبان
سر لشكر	سرلشكر
سر لوحه	سرلوحه
سر مايه	سرمايه
سر مست	سرمست
سر مشق	سرمشق
سر مقاله	سرمقاله
سر منزل	سرمنزل
سر نگون	سرنگون
سر نوشت	سرنوشت
سر نيزه	سرنيزه
سر هنگ	سرهنگ
سر‌آغاز	سرآغاز
سر‌انگشتي	سرانگشتي
سر‌بار	سربار
سر‌باز	سرباز
سر‌بالا	سربالا
سر‌براه	سربراه
سر‌بسته	سربسته
سر‌بلند	سربلند
سر‌بند	سربند
سر‌به نيست	سربه‌نيست
سر‌به‌مهر	سربه‌مهر
سر‌به‌هوا	سربه‌هوا
سر‌پاسبان	سرپاسبان
سر‌پرست	سرپرست
سر‌پنجه	سرپنجه
سر‌پيچ	سرپيچ
سر‌تيپ	سرتيپ
سر‌جوخه	سرجوخه
سر‌چشمه	سرچشمه
سر‌حال	سرحال
سر‌حد	سرحد
سر‌حلقه	سرحلقه
سر‌خر	سرخر
سر‌دبير	سردبير
سر‌در	سردر
سر‌در‌گم	سردرگم
سر‌درختي	سردرختي
سر‌درد	سردرد
سر‌دست	سردست
سر‌دسته	سردسته
سر‌دفتر	سردفتر
سر‌دوشي	سردوشي
سر‌راست	سرراست
سر‌رسيد	سررسيد
سر‌زمين	سرزمين
سر‌زنده	سرزنده
سر‌سبز	سرسبز
سر‌سخت	سرسخت
سر‌سرا	سرسرا
سر‌سره	سرسره
سر‌سنگين	سرسنگين
سر‌سيلندر	سرسيلندر
سر‌شاخ	سرشاخ
سر‌شناس	سرشناس
سر‌شو	سرشو
سر‌شير	سرشير
سر‌غليان	سرغليان
سر‌قفلي	سرقفلي
سر‌كتاب	سركتاب
سر‌كج	سركج
سر‌كرده	سركرده
سر‌كلانتر	سركلانتر
سر‌كنسول	سركنسول
سر‌كوفت	سركوفت
سر‌گرد	سرگرد
سر‌گردان	سرگردان
سر‌گرم	سرگرم
سر‌گروهبان	سرگروهبان
سر‌لشكر	سرلشكر
سر‌لوحه	سرلوحه
سر‌مايه	سرمايه
سر‌مست	سرمست
سر‌مشق	سرمشق
سر‌مقاله	سرمقاله
سر‌منزل	سرمنزل
سر‌نگون	سرنگون
سر‌نوشت	سرنوشت
سر‌نيزه	سرنيزه
سر‌هنگ	سرهنگ
سرا پا	سراپا
سرا پرده	سراپرده
سرا زير	سرازير
سرا سيمه	سراسيمه
سرا شيب	سراشيب
سرا‌پا	سراپا
سرا‌پرده	سراپرده
سراج الدين	سراج‌الدين
سربه زير	سربه‌زير
سربه مهر	سربه‌مهر
سربه نيست	سربه‌نيست
سربه هوا	سربه‌هوا
سرخ آب	سرخاب
سرخ باد	سرخ‌باد
سرخ پوست	سرخ‌پوست
سرخ دار	سرخ‌دار
سرخ رگ	سرخرگ
سرخ‌آب	سرخاب
سرخ‌رگ	سرخرگ
سرخباد	سرخ‌باد
سرخپوست	سرخ‌پوست
سرخدار	سرخ‌دار
سرد آب	سرداب
سرد خانه	سردخانه
سرد سير	سردسير
سرد مزاج	سردمزاج
سرد‌آب	سرداب
سرد‌خانه	سردخانه
سرد‌سير	سردسير
سرد‌مزاج	سردمزاج
سريع السير	سريع‌السير
سريع العمل	سريع‌العمل
سعد الدوله	سعدالدوله
سعد الدين	سعدالدين
سعد الله	سعدالله
سعد بن عباده	سعدبن‌عباده
سعد بن‌عباده	سعدبن‌عباده
سعدبن عباده	سعدبن‌عباده
سعود الفيصل	سعودالفيصل
سفارت خانه	سفارتخانه
سفارت‌خانه	سفارتخانه
سفيد آب	سفيداب
سفيد‌آب	سفيداب
سگ ماهي	سگ‌ماهي
سگماهي	سگ‌ماهي
سلام الله	سلام‌الله
سلام الله عليه	سلام‌الله‌عليه
سلام الله عليها	سلام‌الله‌عليها
سلام الله‌عليه	سلام‌الله‌عليه
سلام الله‌عليها	سلام‌الله‌عليها
سلام‌الله عليه	سلام‌الله‌عليه
سلام‌الله عليها	سلام‌الله‌عليها
سم داران	سم‌داران
سمداران	سم‌داران
سنبل الطيب	سنبل‌الطيب
سنگ باران	سنگ‌باران
سنگ چين	سنگ‌چين
سنگ دل	سنگدل
سنگ ريزه	سنگ‌ريزه
سنگ فروش	سنگ‌فروش
سنگ نوشته	سنگ‌نوشته
سنگ‌دل	سنگدل
سنگباران	سنگ‌باران
سنگچين	سنگ‌چين
سنگريزه	سنگ‌ريزه
سنگفروش	سنگ‌فروش
سنگنوشته	سنگ‌نوشته
سنگين دل	سنگين‌دل
سنگيندل	سنگين‌دل
سه پايه	سه‌پايه
سه تار	سه‌تار
سه چرخه	سه‌چرخه
سه راه	سه‌راه
سه شنبه	سه‌شنبه
سه طلاقه	سه‌طلاقه
سه گوشه	سه‌گوشه
سهم الشركه	سهم‌الشركه
سو گلي	سوگلي
سو‌گلي	سوگلي
سواره نظام	سواره‌نظام
سوخت و ساز	سوخت‌و‌ساز
سوخت وساز	سوخت‌و‌ساز
سوق الجيشي	سوق‌الجيشي
سي مرغ	سيمرغ
سي‌مرغ	سيمرغ
سياه بخت	سياه‌بخت
سياه پوست	سياه‌پوست
سياه چال	سياه‌چال
سياه چرده	سياه‌چرده
سياه دانه	سياه‌دانه
سياه دل	سياه‌دل
سياه رگ	سياه‌رگ
سياه زخم	سياه‌زخم
سياه سرفه	سياه‌سرفه
سياه سوخته	سياه‌سوخته
سياه قلم	سياه‌قلم
سياه گوش	سياه‌گوش
سياه مست	سياه‌مست
سياه نامه	سياه‌نامه
سياهرگ	سياه‌رگ
سياهزخم	سياه‌زخم
سيب زميني	سيب‌زميني
سيد الشهدا	سيدالشهدا
سيد بن طاووس	سيدبن‌طاووس
سيد بن‌طاووس	سيدبن‌طاووس
سيدبن طاووس	سيدبن‌طاووس
سير آب	سيراب
سير آبي	سيرابي
سير الئون	سيرالئون
سير الملوك	سيرالملوك
سير‌آب	سيراب
سير‌آبي	سيرابي
سيف الدين	سيف‌الدين
سيف الله	سيف‌الله
سيف اللهي	سيف‌اللهي
سيل آب	سيلاب
سيل‌آب	سيلاب
سيم آب	سيماب
سيم ساق	سيم‌ساق
سيم‌آب	سيماب
سيمساق	سيم‌ساق
سينه پهلو	سينه‌پهلو
سينه چاك	سينه‌چاك
شاخ شانه	شاخ‌شانه
شاخشانه	شاخ‌شانه
شاد آب	شاداب
شاد باش	شادباش
شاد خوار	شادخوار
شاد روان	شادروان
شاد كام	شادكام
شاد‌آب	شاداب
شاد‌باش	شادباش
شاد‌خوار	شادخوار
شاد‌روان	شادروان
شاد‌كام	شادكام
شانه به سر	شانه‌به‌سر
شانه به‌سر	شانه‌به‌سر
شانه‌به سر	شانه‌به‌سر
شاه باز	شاه‌باز
شاه بالا	شاه‌بالا
شاه بلوط	شاه‌بلوط
شاه پسند	شاه‌پسند
شاه پور	شاهپور
شاه دانه	شاهدانه
شاه دخت	شاه‌دخت
شاه راه	شاهراه
شاه رگ	شاهرگ
شاه رود	شاهرود
شاه سوار	شاهسوار
شاه كار	شاهكار
شاه ماهي	شاه‌ماهي
شاه مقصودي	شاه‌مقصودي
شاه نشين	شاه‌نشين
شاه‌پور	شاهپور
شاه‌دانه	شاهدانه
شاه‌راه	شاهراه
شاه‌رگ	شاهرگ
شاه‌رود	شاهرود
شاه‌سوار	شاهسوار
شاه‌كار	شاهكار
شاهباز	شاه‌باز
شاهدخت	شاه‌دخت
شاهماهي	شاه‌ماهي
شاهن شاه	شاهنشاه
شاهنشين	شاه‌نشين
شب آهنگ	شباهنگ
شب آويز	شباويز
شب بو	شب‌بو
شب پره	شب‌پره
شب تاب	شب‌تاب
شب خوان	شب‌خوان
شب رو	شب‌رو
شب زنده دار	شب‌زنده‌دار
شب زنده‌دار	شب‌زنده‌دار
شب كار	شب‌كار
شب كلاه	شب‌كلاه
شب كور	شبكور
شب گرد	شبگرد
شب گز	شبگز
شب گير	شبگير
شب مانده	شب‌مانده
شب نامه	شب‌نامه
شب نشين	شب‌نشين
شب نم	شبنم
شب نما	شب‌نما
شب‌آهنگ	شباهنگ
شب‌آويز	شباويز
شب‌كور	شبكور
شب‌گرد	شبگرد
شب‌گز	شبگز
شب‌گير	شبگير
شب‌نم	شبنم
شببو	شب‌بو
شبپره	شب‌پره
شبتاب	شب‌تاب
شبخوان	شب‌خوان
شبرو	شب‌رو
شبكار	شب‌كار
شبكلاه	شب‌كلاه
شبمانده	شب‌مانده
شبنامه	شب‌نامه
شبنشين	شب‌نشين
شبنما	شب‌نما
شبي خون	شبيخون
شبي‌خون	شبيخون
شتاب زده	شتاب‌زده
شتابزده	شتاب‌زده
شتر بان	شتربان
شتر گاو	شترگاو
شتر گاو پلنگ	شترگاوپلنگ
شتر گربه	شترگربه
شتر گلو	شترگلو
شتر گياه	شترگياه
شتر مرغ	شترمرغ
شتر‌بان	شتربان
شتر‌گاو	شترگاو
شتر‌گاو‌پلنگ	شترگاوپلنگ
شتر‌گربه	شترگربه
شتر‌گلو	شترگلو
شتر‌گياه	شترگياه
شتر‌مرغ	شترمرغ
شديد اللحن	شديداللحن
شديد اللحني	شديداللحني
شراب خانه	شراب‌خانه
شراب خوار	شراب‌خوار
شراب سازي	شراب‌سازي
شرابخانه	شراب‌خانه
شرابخوار	شراب‌خوار
شرابسازي	شراب‌سازي
شرايع الاسلام	شرايع‌الاسلام
شرف الدين	شرف‌الدين
شرم الشيخ	شرم‌الشيخ
شرم زده	شرم‌زده
شرمزده	شرم‌زده
شست شو	شستشو
شست‌شو	شستشو
شش در	شش‌در
شش لول	ششلول
شش‌لول	ششلول
ششدر	شش‌در
شكر آب	شكرآب
شكر الله	شكرالله
شكر خند	شكرخند
شكر گزار	شكرگزار
شكر‌آب	شكرآب
شكر‌خند	شكرخند
شكر‌گزار	شكرگزار
شكسته بندي	شكسته‌بندي
شكسته نفسي	شكسته‌نفسي
شكم پايان	شكم‌پايان
شكمپايان	شكم‌پايان
شلنگ تخته	شلنگ‌تخته
شمس الدوله	شمس‌الدوله
شمس الدين	شمس‌الدين
شمس العماره	شمس‌العماره
شناس نامه	شناسنامه
شناس‌نامه	شناسنامه
شه بانو	شهبانو
شه پر	شهپر
شه ناز	شهناز
شه‌بانو	شهبانو
شه‌پر	شهپر
شه‌ناز	شهناز
شهاب الدين	شهاب‌الدين
شهر دار	شهردار
شهر وند	شهروند
شهر يار	شهريار
شهر‌دار	شهردار
شهر‌وند	شهروند
شهر‌يار	شهريار
شيخ الاسلام	شيخ‌الاسلام
شيخ الاسلامي	شيخ‌الاسلامي
شير برنج	شيربرنج
شير بها	شيربها
شير خشك	شيرخشك
شير خوار	شيرخوار
شير دل	شيردل
شير فهم	شيرفهم
شير گياه	شيرگياه
شير‌برنج	شيربرنج
شير‌بها	شيربها
شير‌خشك	شيرخشك
شير‌خوار	شيرخوار
شير‌دل	شيردل
شير‌فهم	شيرفهم
شير‌گياه	شيرگياه
صاحب الامر	صاحب‌الامر
صاحب الزمان	صاحب‌الزمان
صاحب جمع	صاحب‌جمع
صاحب دل	صاحب‌دل
صاحب نظر	صاحب‌نظر
صاحبجمع	صاحب‌جمع
صاحبدل	صاحب‌دل
صاحبنظر	صاحب‌نظر
صبح دم	صبحدم
صبح‌دم	صبحدم
صد برگ	صدبرگ
صد توماني	صدتوماني
صد‌برگ	صدبرگ
صد‌توماني	صدتوماني
صدر الدين	صدرالدين
صدر المتألهين	صدرالمتألهين
صعب العبور	صعب‌العبور
صعب العلاج	صعب‌العلاج
صفي الدين	صفي‌الدين
صلاح الدين	صلاح‌الدين
صلوات الله	صلوات‌الله
صلي الله	صلي‌الله
صندوق خانه	صندوق‌خانه
صندوقخانه	صندوق‌خانه
صنيع الدوله	صنيع‌الدوله
صنيع الملك	صنيع‌الملك
ضرب الاجل	ضرب‌الاجل
ضرب المثل	ضرب‌المثل
ضرب المثل ها	ضرب‌المثل‌ها
ضرب المثل‌ها	ضرب‌المثل‌ها
ضرب‌المثل ها	ضرب‌المثل‌ها
ضياء الحق	ضياءالحق
ضياء الدين	ضياءالدين
طاس كباب	طاس‌كباب
طاسكباب	طاس‌كباب
طاق ديس	طاقديس
طاق‌ديس	طاقديس
طويل المدت	طويل‌المدت
ظل السلطان	ظل‌السلطان
ظهير الدوله	ظهيرالدوله
ظهير الدين	ظهيرالدين
عاشق پيشه	عاشق‌پيشه
عام المنفعه	عام‌المنفعه
عباد الله	عبادالله
عبد الامير	عبدالامير
عبد الباقي	عبدالباقي
عبد الجبار	عبدالجبار
عبد الجليل	عبدالجليل
عبد الجواد	عبدالجواد
عبد الحسين	عبدالحسين
عبد الحسيني	عبدالحسيني
عبد الحليم	عبدالحليم
عبد الحميد	عبدالحميد
عبد الحي	عبدالحي
عبد الخالق	عبدالخالق
عبد الرازق	عبدالرازق
عبد الرحمان	عبدالرحمان
عبد الرحمن	عبدالرحمن
عبد الرحيم	عبدالرحيم
عبد الرزاق	عبدالرزاق
عبد الرسول	عبدالرسول
عبد الرشيد	عبدالرشيد
عبد الرضا	عبدالرضا
عبد الرفيع	عبدالرفيع
عبد الستار	عبدالستار
عبد السلام	عبدالسلام
عبد الصمد	عبدالصمد
عبد العال	عبدالعال
عبد العالي	عبدالعالي
عبد العزيز	عبدالعزيز
عبد العظيم	عبدالعظيم
عبد العلي	عبدالعلي
عبد العلي زاده	عبدالعلي‌زاده
عبد العلي‌زاده	عبدالعلي‌زاده
عبد الغفار	عبدالغفار
عبد الغني	عبدالغني
عبد الفتاح	عبدالفتاح
عبد القادر	عبدالقادر
عبد الكريم	عبدالكريم
عبد اللطيف	عبداللطيف
عبد الله	عبدالله
عبد الله بن زبير	عبدالله‌بن‌زبير
عبد الله بن عباس	عبدالله‌بن‌عباس
عبد الله بن عمر	عبدالله‌بن‌عمر
عبد الله بن‌زبير	عبدالله‌بن‌زبير
عبد الله بن‌عباس	عبدالله‌بن‌عباس
عبد الله بن‌عمر	عبدالله‌بن‌عمر
عبد الله زاده	عبدالله‌زاده
عبد الله‌بن زبير	عبدالله‌بن‌زبير
عبد الله‌بن عباس	عبدالله‌بن‌عباس
عبد الله‌بن عمر	عبدالله‌بن‌عمر
عبد الله‌بن‌زبير	عبدالله‌بن‌زبير
عبد الله‌بن‌عباس	عبدالله‌بن‌عباس
عبد الله‌بن‌عمر	عبدالله‌بن‌عمر
عبد الله‌زاده	عبدالله‌زاده
عبد اللهي	عبداللهي
عبد المجيد	عبدالمجيد
عبد المحسن	عبدالمحسن
عبد المحمد	عبدالمحمد
عبد المطلب	عبدالمطلب
عبد الملك	عبدالملك
عبد الملكي	عبدالملكي
عبد المنعم	عبدالمنعم
عبد الناصر	عبدالناصر
عبد النبي	عبدالنبي
عبد الهادي	عبدالهادي
عبد الواحد	عبدالواحد
عبد الوهاب	عبدالوهاب
عبدالعلي زاده	عبدالعلي‌زاده
عبدالله بن زبير	عبدالله‌بن‌زبير
عبدالله بن عباس	عبدالله‌بن‌عباس
عبدالله بن عمر	عبدالله‌بن‌عمر
عبدالله بن‌زبير	عبدالله‌بن‌زبير
عبدالله بن‌عباس	عبدالله‌بن‌عباس
عبدالله بن‌عمر	عبدالله‌بن‌عمر
عبدالله زاده	عبدالله‌زاده
عبدالله‌بن زبير	عبدالله‌بن‌زبير
عبدالله‌بن عباس	عبدالله‌بن‌عباس
عبدالله‌بن عمر	عبدالله‌بن‌عمر
عبيد الله	عبيدالله
عجل الله	عجل‌الله
عز الدوله	عزالدوله
عز الدين	عزالدين
عزت الله	عزت‌الله
عزيز الله	عزيزالله
عضد الدوله	عضدالدوله
عضد الملك	عضدالملك
عطاء الله	عطاءالله
عظيم الجثه	عظيم‌الجثه
عظيم الشأن	عظيم‌الشأن
عكس العمل	عكس‌العمل
عكس العمل ها	عكس‌العمل‌ها
عكس العمل هاي	عكس‌العمل‌هاي
عكس العمل‌ها	عكس‌العمل‌ها
عكس العمل‌هاي	عكس‌العمل‌هاي
عكس العملي	عكس‌العملي
عكس‌العمل ها	عكس‌العمل‌ها
عكس‌العمل هاي	عكس‌العمل‌هاي
علاء الدوله	علاءالدوله
علاء الدين	علاءالدين
علم الاشياء	علم‌الاشياء
علم الهدي	علم‌الهدي
علي الاصول	علي‌الاصول
علي الاطلاق	علي‌الاطلاق
علي البدل	علي‌البدل
علي الحساب	علي‌الحساب
علي الخصوص	علي‌الخصوص
علي الظاهر	علي‌الظاهر
علي القاعده	علي‌القاعده
علي الله	علي‌الله
علي بن الحسين	علي‌بن‌الحسين
علي بن موسي	علي‌بن‌موسي
علي بن موسي الرضا	علي‌بن‌موسي‌الرضا
علي بن موسي‌الرضا	علي‌بن‌موسي‌الرضا
علي بن‌الحسين	علي‌بن‌الحسين
علي بن‌موسي	علي‌بن‌موسي
علي بن‌موسي الرضا	علي‌بن‌موسي‌الرضا
علي بن‌موسي‌الرضا	علي‌بن‌موسي‌الرضا
علي‌بن الحسين	علي‌بن‌الحسين
علي‌بن موسي	علي‌بن‌موسي
علي‌بن موسي الرضا	علي‌بن‌موسي‌الرضا
علي‌بن موسي‌الرضا	علي‌بن‌موسي‌الرضا
علي‌بن‌موسي الرضا	علي‌بن‌موسي‌الرضا
عليه السلام	عليه‌السلام
عليها السلام	عليهاالسلام
عليهم السلام	عليهم‌السلام
عليهما السلام	عليهماالسلام
عماد الدوله	عمادالدوله
عماد الدين	عمادالدين
عمر البشير	عمرالبشير
عمر بن خطاب	عمربن‌خطاب
عمر بن عبد العزيز	عمربن‌عبدالعزيز
عمر بن عبدالعزيز	عمربن‌عبدالعزيز
عمر بن‌خطاب	عمربن‌خطاب
عمر بن‌عبد العزيز	عمربن‌عبدالعزيز
عمر بن‌عبدالعزيز	عمربن‌عبدالعزيز
عمربن خطاب	عمربن‌خطاب
عمربن عبد العزيز	عمربن‌عبدالعزيز
عمربن عبدالعزيز	عمربن‌عبدالعزيز
عمربن‌عبد العزيز	عمربن‌عبدالعزيز
عميد الملك	عميدالملك
عنايت الله	عنايت‌الله
عند اللزوم	عنداللزوم
عند الله	عندالله
عند المطالبه	عندالمطالبه
عنصر المعالي	عنصرالمعالي
عوام الناس	عوام‌الناس
عوايد الايام	عوايدالايام
عين الدوله	عين‌الدوله
عين الدين	عين‌الدين
عين الله	عين‌الله
غرر الحكم	غررالحكم
غياث الدين	غياث‌الدين
غير الزامي	غيرالزامي
غير الهي	غيرالهي
فارغ التحصيل	فارغ‌التحصيل
فارغ التحصيلان	فارغ‌التحصيلان
فارغ التحصيلي	فارغ‌التحصيلي
فال گوش	فالگوش
فال‌گوش	فالگوش
فتح الله	فتح‌الله
فتح اللهي	فتح‌اللهي
فتح المبين	فتح‌المبين
فخر الدوله	فخرالدوله
فخر الدين	فخرالدين
فخر الديني	فخرالديني
فخر المحققين	فخرالمحققين
فرا بنفش	فرابنفش
فرا خود	فراخود
فرا خور	فراخور
فرا ساخت	فراساخت
فرا‌بنفش	فرابنفش
فرا‌خود	فراخود
فرا‌خور	فراخور
فرا‌ساخت	فراساخت
فرج الله	فرج‌الله
فرمان ده	فرمانده
فرمان روا	فرمانروا
فرمان‌ده	فرمانده
فرمان‌روا	فرمانروا
فرو تن	فروتن
فرو دست	فرودست
فرو ساخت	فروساخت
فرو مايه	فرومايه
فرو‌تن	فروتن
فرو‌ساخت	فروساخت
فرو‌مايه	فرومايه
فريد الدين	فريدالدين
فصل الخطاب	فصل‌الخطاب
فصل نامه	فصلنامه
فصل‌نامه	فصلنامه
فضل الله	فضل‌الله
فقه القرآن	فقه‌القرآن
فقه اللغه	فقه‌اللغه
فوق الاشاره	فوق‌الاشاره
فوق الذكر	فوق‌الذكر
فوق العادة	فوق‌العادة
فوق العاده	فوق‌العاده
فوق العاده‌اش	فوق‌العاده‌اش
فوق العاده‌اند	فوق‌العاده‌اند
فوق العاده‌اي	فوق‌العاده‌اي
في الارض	في‌الارض
في البداهه	في‌البداهه
في الجمله	في‌الجمله
في المثل	في‌المثل
في الواقع	في‌الواقع
في سبيل الله	في‌سبيل‌الله
في سبيل‌الله	في‌سبيل‌الله
في‌سبيل الله	في‌سبيل‌الله
فيض الله	فيض‌الله
قائم مقام	قائم‌مقام
قحط سالي	قحط‌سالي
قحطسالي	قحط‌سالي
قدرت الله	قدرت‌الله
قديم الايام	قديم‌الايام
قرا قروت	قراقروت
قرض الحسنه	قرض‌الحسنه
قره العين	قره‌العين
قريب الوقوع	قريب‌الوقوع
قصر الدشت	قصرالدشت
قطب الدين	قطب‌الدين
قطع نامه	قطعنامه
قطع‌نامه	قطعنامه
قلم دوش	قلمدوش
قلم‌دوش	قلمدوش
قمار خانه	قمارخانه
قمار‌خانه	قمارخانه
قند پهلو	قندپهلو
قند داغ	قندداغ
قند شكن	قندشكن
قند‌پهلو	قندپهلو
قند‌داغ	قندداغ
قند‌شكن	قندشكن
قوام الدين	قوام‌الدين
قوام السلطنه	قوام‌السلطنه
قوس قزح	قوس‌قزح
كار آگاه	كارآگاه
كار پرداز	كارپرداز
كار خانه	كارخانه
كار دستي	كاردستي
كار گزين	كارگزين
كار مزد	كارمزد
كار نامه	كارنامه
كار‌آگاه	كارآگاه
كار‌پرداز	كارپرداز
كار‌خانه	كارخانه
كار‌دستي	كاردستي
كار‌گزين	كارگزين
كار‌مزد	كارمزد
كار‌نامه	كارنامه
كاس برگ	كاسبرگ
كاس‌برگ	كاسبرگ
كاسب كار	كاسب‌كار
كاسبكار	كاسب‌كار
كاسه پشت	كاسه‌پشت
كاشف الغطاء	كاشف‌الغطاء
كام روا	كامروا
كام ياب	كامياب
كام يار	كاميار
كام‌روا	كامروا
كام‌ياب	كامياب
كام‌يار	كاميار
كتاب الله	كتاب‌الله
كتاب فروش	كتاب‌فروش
كتابفروش	كتاب‌فروش
كثير الاضلاع	كثيرالاضلاع
كثير الانتشار	كثيرالانتشار
كثير الشك	كثيرالشك
كش مكش	كشمكش
كش‌مكش	كشمكش
كشف الاسرار	كشف‌الاسرار
كفش كن	كفش‌كن
كفشكن	كفش‌كن
كلام الله	كلام‌الله
كلفت بار	كلفت‌بار
كلفتبار	كلفت‌بار
كلمة الله	كلمةالله
كما في السابق	كمافي‌السابق
كما في‌السابق	كمافي‌السابق
كمافي السابق	كمافي‌السابق
كمال الدين	كمال‌الدين
كمال الملك	كمال‌الملك
كمر بند	كمربند
كمر‌بند	كمربند
كوچه باغ	كوچه‌باغ
كيسه داران	كيسه‌داران
كيلو گرم	كيلوگرم
كيلو متر	كيلومتر
كيلو‌گرم	كيلوگرم
كيلو‌متر	كيلومتر
گاز انبر	گازانبر
گاز‌انبر	گازانبر
گاه نامه	گاهنامه
گاه‌نامه	گاهنامه
گاو آهن	گاوآهن
گاو زبان	گاوزبان
گاو صندوق	گاوصندوق
گاو ميش	گاوميش
گاو‌آهن	گاوآهن
گاو‌زبان	گاوزبان
گاو‌صندوق	گاوصندوق
گاو‌ميش	گاوميش
گذر نامه	گذرنامه
گذر‌نامه	گذرنامه
گران بار	گران‌بار
گران بها	گران‌بها
گران جان	گران‌جان
گران سر	گران‌سر
گران قدر	گران‌قدر
گران مايه	گران‌مايه
گرانبار	گران‌بار
گرانبها	گران‌بها
گرانجان	گران‌جان
گرانسر	گران‌سر
گرانقدر	گران‌قدر
گرانمايه	گران‌مايه
گرد آب	گرداب
گرد باد	گردباد
گرد‌آب	گرداب
گرد‌باد	گردباد
گرگ و ميش	گرگ‌و‌ميش
گرگم به هوا	گرگم‌به‌هوا
گرم سير	گرمسير
گرم مزاج	گرم‌مزاج
گرم‌سير	گرمسير
گرممزاج	گرم‌مزاج
گرين كارت	گرين‌كارت
گل آب	گلاب
گل آبي	گلابي
گل آذين	گل‌آذين
گل بانگ	گلبانگ
گل برگ	گلبرگ
گل پر	گلپر
گل خانه	گلخانه
گل در چمن	گل‌درچمن
گل دسته	گلدسته
گل رنگ	گلرنگ
گل سنگ	گل‌سنگ
گل گشت	گلگشت
گل گون	گلگون
گل مژه	گل‌مژه
گل مولا	گل‌مولا
گل ميخ	گل‌ميخ
گل نار	گلنار
گل‌آب	گلاب
گل‌آبي	گلابي
گل‌بانگ	گلبانگ
گل‌برگ	گلبرگ
گل‌پر	گلپر
گل‌خانه	گلخانه
گل‌دسته	گلدسته
گل‌رنگ	گلرنگ
گل‌گشت	گلگشت
گل‌گون	گلگون
گل‌نار	گلنار
گلسنگ	گل‌سنگ
گلمژه	گل‌مژه
گلمولا	گل‌مولا
گلميخ	گل‌ميخ
گم راه	گمراه
گم نام	گمنام
گم‌راه	گمراه
گم‌نام	گمنام
گنج نامه	گنج‌نامه
گنجنامه	گنج‌نامه
گند آب	گنداب
گند‌آب	گنداب
گندم گون	گندمگون
گندم‌گون	گندمگون
گو ناگون	گوناگون
گواهي نامه	گواهي‌نامه
گواهينامه	گواهي‌نامه
گوجه فرنگي	گوجه‌فرنگي
گوش فيل	گوش‌فيل
گوش ماهي	گوش‌ماهي
گوشت تلخ	گوشت‌تلخ
گونا گون	گوناگون
گياه شناس	گياه‌شناس
گياهشناس	گياه‌شناس
گير بكس	گيربكس
گير‌بكس	گيربكس
لا اله الا الله	لااله‌الاالله
لا اله الاالله	لااله‌الاالله
لا اله‌الا الله	لااله‌الاالله
لا اله‌الاالله	لااله‌الاالله
لا به لا	لابه‌لا
لا طائلات	لاطائلات
لا كتاب	لاكتاب
لا مذهب	لامذهب
لا مروت	لامروت
لا مكان	لامكان
لا وصول	لاوصول
لا يتغير	لايتغير
لا يتناهي	لايتناهي
لا يزال	لايزال
لا يموت	لايموت
لا‌به‌لا	لابه‌لا
لا‌طائلات	لاطائلات
لا‌كتاب	لاكتاب
لا‌مذهب	لامذهب
لا‌مكان	لامكان
لا‌وصول	لاوصول
لا‌يتغير	لايتغير
لا‌يتناهي	لايتناهي
لا‌يزال	لايزال
لا‌يموت	لايموت
لااله الا الله	لااله‌الاالله
لااله الاالله	لااله‌الاالله
لااله‌الا الله	لااله‌الاالله
لازم الاتباع	لازم‌الاتباع
لازم الاجرا	لازم‌الاجرا
لازم الاجراست	لازم‌الاجراست
لازم التعليم	لازم‌التعليم
لاك پشت	لاك‌پشت
لاكپشت	لاك‌پشت
لاله عباسي	لاله‌عباسي
لب خند	لبخند
لب‌خند	لبخند
لبا لب	لبالب
لطف الله	لطف‌الله
لقاء الله	لقاءالله
لك لك	لك‌لك
لوازم التحرير	لوازم‌التحرير
لوز المعده	لوزالمعده
ليلة القدر	ليلةالقدر
ما بعد	مابعد
ما بعد الطبيعه	مابعدالطبيعه
ما بعد الطبيعي	مابعدالطبيعي
ما بعدالطبيعه	مابعدالطبيعه
ما بعدالطبيعي	مابعدالطبيعي
ما به التفاوت	مابه‌التفاوت
ما به‌التفاوت	مابه‌التفاوت
ما شاء الله	ماشاءالله
ما شاءالله	ماشاءالله
ما لامال	مالامال
ما يحتاج	مايحتاج
ما يملك	مايملك
ما‌بعد	مابعد
ما‌يحتاج	مايحتاج
ما‌يملك	مايملك
ماء الشعير	ماء‌الشعير
مابعد الطبيعه	مابعدالطبيعه
مابعد الطبيعي	مابعدالطبيعي
مابه التفاوت	مابه‌التفاوت
مادام العمر	مادام‌العمر
مادر به خطا	مادر‌به‌خطا
مار پيچ	مارپيچ
مار چوبه	مارچوبه
مار ماهي	مارماهي
مار‌پيچ	مارپيچ
مار‌چوبه	مارچوبه
مار‌ماهي	مارماهي
ماشاء الله	ماشاءالله
مال الاجاره	مال‌الاجاره
مال التجاره	مال‌التجاره
مال الله	مال‌الله
مالا مال	مالامال
ماه پاره	ماه‌پاره
ماه رخ	ماهرخ
ماه رو	ماهرو
ماه سيما	ماه‌سيما
ماه گرفتگي	ماه‌گرفتگي
ماه منظر	ماه‌منظر
ماه نامه	ماهنامه
ماه‌رخ	ماهرخ
ماه‌رو	ماهرو
ماه‌نامه	ماهنامه
ماهپاره	ماه‌پاره
ماهسيما	ماه‌سيما
ماهي تابه	ماهيتابه
ماهي خوار	ماهيخوار
ماهي گير	ماهيگير
ماهي‌تابه	ماهيتابه
ماهي‌خوار	ماهيخوار
ماهي‌گير	ماهيگير
ماوراء الطبيعه	ماوراءالطبيعه
ماوراء الطبيعي	ماوراءالطبيعي
ماوراء النهر	ماوراءالنهر
مايه كوبي	مايه‌كوبي
متحد الشكل	متحدالشكل
متحد المركز	متحدالمركز
مجد الدوله	مجدالدوله
مجد الدين	مجدالدين
مجمع البيان	مجمع‌البيان
مجمع الجزاير	مجمع‌الجزاير
محب الدين	محب‌الدين
محمد بن	محمدبن
محمد بن ابي بكر	محمدبن‌ابي‌بكر
محمد بن ابي‌بكر	محمدبن‌ابي‌بكر
محمد بن حنفيه	محمدبن‌حنفيه
محمد بن عبد الله	محمدبن‌عبدالله
محمد بن عبدالله	محمدبن‌عبدالله
محمد بن علي	محمدبن‌علي
محمد بن‌ابي بكر	محمدبن‌ابي‌بكر
محمد بن‌ابي‌بكر	محمدبن‌ابي‌بكر
محمد بن‌حنفيه	محمدبن‌حنفيه
محمد بن‌عبد الله	محمدبن‌عبدالله
محمد بن‌عبدالله	محمدبن‌عبدالله
محمد بن‌علي	محمدبن‌علي
محمدبن ابي بكر	محمدبن‌ابي‌بكر
محمدبن ابي‌بكر	محمدبن‌ابي‌بكر
محمدبن حنفيه	محمدبن‌حنفيه
محمدبن عبد الله	محمدبن‌عبدالله
محمدبن عبدالله	محمدبن‌عبدالله
محمدبن علي	محمدبن‌علي
محمدبن‌ابي بكر	محمدبن‌ابي‌بكر
محمدبن‌عبد الله	محمدبن‌عبدالله
محي الدين	محي‌الدين
محير العقول	محيرالعقول
محيي الدين	محيي‌الدين
مخبر الدوله	مخبرالدوله
مخبر السلطنه	مخبرالسلطنه
مدظله العالي	مدظله‌العالي
مدعي العموم	مدعي‌العموم
مرد آب	مرداب
مرد‌آب	مرداب
مرغ آبي	مرغابي
مرغ‌آبي	مرغابي
مركور كرم	مركوركرم
مركور‌كرم	مركوركرم
مرگ موش	مرگ‌موش
مستشار الدوله	مستشارالدوله
مستوفي الممالك	مستوفي‌الممالك
مسجد الاقصي	مسجدالاقصي
مسجد الحرام	مسجدالحرام
مسجد الرضا	مسجدالرضا
مسجد النبي	مسجدالنبي
مشار اليه	مشاراليه
مشترك المنافع	مشترك‌المنافع
مشكوك الوصول	مشكوك‌الوصول
مشير الدوله	مشيرالدوله
مصلح الدين	مصلح‌الدين
مصور الملكي	مصورالملكي
مضاف اليه	مضاف‌اليه
مظفر الدين	مظفرالدين
مع الاسف	مع‌الاسف
مع الوصف	مع‌الوصف
معتمد الدوله	معتمدالدوله
معتمد السلطان	معتمدالسلطان
معرفت الله	معرفت‌الله
معز الدوله	معزالدوله
معز الدين	معزالدين
معير الممالك	معيرالممالك
معين الدين	معين‌الدين
مغ بچه	مغ‌بچه
مفقود الاثر	مفقودالاثر
مگا هرتز	مگاهرتز
مگا‌هرتز	مگاهرتز
ملا نصر الدين	ملانصرالدين
ملا نصرالدين	ملانصرالدين
ملال آور	ملال‌آور
ملال انگيز	ملال‌انگيز
ملانصر الدين	ملانصرالدين
ملك الشعراي	ملك‌الشعراي
ملك المتكلمين	ملك‌المتكلمين
منطق الطير	منطق‌الطير
مه پاره	مهپاره
مه تاب	مهتاب
مه دخت	مهدخت
مه‌پاره	مهپاره
مه‌تاب	مهتاب
مه‌دخت	مهدخت
مهدور الدم	مهدورالدم
مهر گياه	مهرگياه
مهر‌گياه	مهرگياه
مهره داران	مهره‌داران
مهمان خانه	مهمانخانه
مهمان دار	مهماندار
مهمان سرا	مهمان‌سرا
مهمان‌خانه	مهمانخانه
مهمان‌دار	مهماندار
مهمانسرا	مهمان‌سرا
مو چين	موچين
مو خوره	موخوره
مو سير	موسير
مو شكافي	موشكافي
مو‌چين	موچين
مو‌خوره	موخوره
مو‌سير	موسير
مو‌شكافي	موشكافي
مور مور	مورمور
مور‌مور	مورمور
مورچه خوار	مورچه‌خوار
موسي الرضا	موسي‌الرضا
موسي بن جعفر	موسي‌بن‌جعفر
موسي بن‌جعفر	موسي‌بن‌جعفر
موسي‌بن جعفر	موسي‌بن‌جعفر
مونو لوگ	مونولوگ
مونو‌لوگ	مونولوگ
موي رگ	مويرگ
موي‌رگ	مويرگ
مي خانه	ميخانه
مي گون	ميگون
مي‌خانه	ميخانه
مي‌گون	ميگون
ميان بر	ميان‌بر
ميان پرده	ميان‌پرده
ميان دار	ميان‌دار
ميان دل	ميان‌دل
ميان سال	ميان‌سال
ميانبر	ميان‌بر
مياندار	ميان‌دار
مياندل	ميان‌دل
ميانسال	ميان‌سال
ميخ كوب	ميخ‌كوب
ميخكوب	ميخ‌كوب
مير آب	ميراب
مير پنج	ميرپنج
مير جلال الدين	ميرجلال‌الدين
مير جلال‌الدين	ميرجلال‌الدين
مير زاد	ميرزاد
مير شكار	ميرشكار
مير غضب	ميرغضب
مير ميران	ميرميران
مير‌آب	ميراب
مير‌پنج	ميرپنج
مير‌زاد	ميرزاد
مير‌شكار	ميرشكار
مير‌غضب	ميرغضب
مير‌ميران	ميرميران
ميرجلال الدين	ميرجلال‌الدين
ميز بان	ميزبان
ميز‌بان	ميزبان
ميكرو بيولوژي	ميكروبيولوژي
ميكرو فيلم	ميكروفيلم
ميكرو‌بيولوژي	ميكروبيولوژي
ميكرو‌فيلم	ميكروفيلم
ميكروب شناس	ميكروب‌شناس
ميكروبشناس	ميكروب‌شناس
ميل لنگ	ميل‌لنگ
ناخن خشك	ناخن‌خشك
ناز بالش	نازبالش
ناز خاتون	نازخاتون
ناز خواب	نازخواب
ناز‌بالش	نازبالش
ناز‌خاتون	نازخاتون
ناز‌خواب	نازخواب
نازك بالان	نازك‌بالان
نازك ني	نازك‌ني
ناصر الدين	ناصرالدين
ناصر الدين شاه	ناصرالدين‌شاه
ناصر الدين‌شاه	ناصرالدين‌شاه
ناصر الملك	ناصرالملك
ناصرالدين شاه	ناصرالدين‌شاه
ناظم الاسلام	ناظم‌الاسلام
ناو ديس	ناوديس
ناو‌ديس	ناوديس
نايب السلطنه	نايب‌السلطنه
نبي الله	نبي‌الله
نجات الهي	نجات‌الهي
نجم الدين	نجم‌الدين
نخست وزير	نخست‌وزير
نر مادگي	نرمادگي
نر ماده	نرماده
نر و ماده	نروماده
نر‌مادگي	نرمادگي
نر‌ماده	نرماده
نر‌و‌ماده	نروماده
نرم تنان	نرم‌تنان
نرم شامه	نرم‌شامه
نرمتنان	نرم‌تنان
نزديك بين	نزديك‌بين
نصر الدين	نصرالدين
نصر الله	نصرالله
نصرت الله	نصرت‌الله
نصف النهار	نصف‌النهار
نصير الدوله	نصيرالدوله
نصير الدين	نصيرالدين
نظام الدين	نظام‌الدين
نظام الملك	نظام‌الملك
نعمت الله	نعمت‌الله
نعوذ بالله	نعوذبالله
نفس الامر	نفس‌الامر
نم نم	نم‌نم
نمايش نامه	نمايشنامه
نمايش‌نامه	نمايشنامه
نهان بر	نهان‌بر
نهان دانه	نهان‌دانه
نهاندانه	نهان‌دانه
نهج البلاغه	نهج‌البلاغه
نو باوه	نوباوه
نو بر	نوبر
نو بنياد	نوبنياد
نو بهار	نوبهار
نو پا	نوپا
نو جوان	نوجوان
نو روز	نوروز
نو سنگي	نوسنگي
نو سواد	نوسواد
نو عروس	نوعروس
نو كيسه	نوكيسه
نو نهال	نونهال
نو نوار	نونوار
نو‌باوه	نوباوه
نو‌بر	نوبر
نو‌بنياد	نوبنياد
نو‌بهار	نوبهار
نو‌پا	نوپا
نو‌جوان	نوجوان
نو‌روز	نوروز
نو‌سنگي	نوسنگي
نو‌سواد	نوسواد
نو‌عروس	نوعروس
نو‌كيسه	نوكيسه
نو‌نهال	نونهال
نو‌نوار	نونوار
نوا خانه	نواخانه
نوا‌خانه	نواخانه
نوان خانه	نوانخانه
نوان‌خانه	نوانخانه
نور الانوار	نورالانوار
نور الدين	نورالدين
نور الله	نورالله
نور اللهي	نوراللهي
نوش آبه	نوشابه
نوش خند	نوشخند
نوش‌آبه	نوشابه
نوش‌خند	نوشخند
نوشا نوش	نوشانوش
ني داود	ني‌داود
ني شكر	نيشكر
ني لبك	ني‌لبك
نيش خند	نيشخند
نيش‌خند	نيشخند
نيكو نام	نيكونام
نيكو‌نام	نيكونام
نيل گون	نيلگون
نيل‌گون	نيلگون
نيم بالان	نيم‌بالان
نيم بند	نيم‌بند
نيم تاج	نيم‌تاج
نيم تنه	نيم‌تنه
نيم جان	نيم‌جان
نيم خيز	نيم‌خيز
نيم دار	نيم‌دار
نيم دايره	نيم‌دايره
نيم رخ	نيم‌رخ
نيم رو	نيمرو
نيم روز	نيمروز
نيم ساز	نيمساز
نيم كاسه	نيم‌كاسه
نيم كره	نيمكره
نيم واكه	نيم‌واكه
نيم‌رو	نيمرو
نيم‌روز	نيمروز
نيم‌ساز	نيمساز
نيم‌كره	نيمكره
نيمبند	نيم‌بند
نيمتاج	نيم‌تاج
نيمجان	نيم‌جان
نيمخيز	نيم‌خيز
نيمدار	نيم‌دار
نيمدايره	نيم‌دايره
نيمرخ	نيم‌رخ
نيمواكه	نيم‌واكه
هارون الرشيد	هارون‌الرشيد
هدايت الله	هدايت‌الله
هزار برگ	هزاربرگ
هزار پا	هزارپا
هزار پيشه	هزار‌پيشه
هزار چشم	هزارچشم
هزار دستان	هزاردستان
هزار‌برگ	هزاربرگ
هزار‌پا	هزارپا
هزار‌چشم	هزارچشم
هزار‌دستان	هزاردستان
هشت پا	هشت‌پا
هشتپا	هشت‌پا
هفت اندام	هفت‌اندام
هفت بيجار	هفت‌بيجار
هفت خط	هفت‌خط
هفت سرهنگ	هفت‌سرهنگ
هفت سين	هفت‌سين
هفت قلم	هفت‌قلم
هفتاندام	هفت‌اندام
هفتبيجار	هفت‌بيجار
هفتخط	هفت‌خط
هفتسرهنگ	هفت‌سرهنگ
هفتسين	هفت‌سين
هفتقلم	هفت‌قلم
هم آشيان	هم‌آشيان
هم آغوش	هم‌آغوش
هم درد	همدرد
هم‌درد	همدرد
هماغوش	هم‌آغوش
هميشه بهار	هميشه‌بهار
هوا برد	هوابرد
هوا سنج	هواسنج
هوا شناس	هواشناس
هوا‌برد	هوابرد
هوا‌سنج	هواسنج
هوا‌شناس	هواشناس
و الارض	والارض
و الذي	والذي
و الذين	والذين
و السلام	والسلام
و العصر	والعصر
و الفجر	والفجر
و الله	والله
واجب الوجود	واجب‌الوجود
واژه نامه	واژه‌نامه
وايت برد	وايت‌برد
وايتبرد	وايت‌برد
وجه الضمان	وجه‌الضمان
وسائل الشيعه	وسائل‌الشيعه
ول خرج	ولخرج
ول‌خرج	ولخرج
ولي الله	ولي‌الله
ويل  چر	ويلچر
ويل‌چر	ويلچر
يا مفت	يامفت
يا‌مفت	يامفت
ياد گيري	يادگيري
ياد‌گيري	يادگيري
يخ بندان	يخ‌بندان
يخ چال	يخچال
يخ در بهشت	يخ‌دربهشت
يخ‌چال	يخچال
يخبندان	يخ‌بندان
يخچال فريزر	يخچال‌فريزر
يخدربهشت	يخ‌دربهشت
يد الله	يدالله
يدك كش	يدك‌كش
يدككش	يدك‌كش
يريد الله	يريدالله
يك پايه	يك‌پايه
يك تا	يكتا
يك دست	يكدست
يك دل	يكدل
يك دنده	يك‌دنده
يك رنگ	يكرنگ
يك سر	يكسر
يك شنبه	يكشنبه
يك‌تا	يكتا
يك‌دست	يكدست
يك‌دل	يكدل
يك‌رنگ	يكرنگ
يك‌سر	يكسر
يك‌شنبه	يكشنبه
يكپايه	يك‌پايه
يكدنده	يك‌دنده
يكي به دو	يكي‌به‌دو
يوز پلنگ	يوزپلنگ
يوز‌پلنگ	يوزپلنگ
آب و هوا	آب‌وهوا
آب و هواي	آب‌وهواي
رعد و برق	رعدوبرق
گرد و خاك	گردوخاك
گرد و غبارهاي	گردوغبارهاي
گرد و غبار	گردوغبار
گرد و غباري	گردوغباري
آب و تاب	آب‌وتاب
آب و خاك	آب‌وخاك
خوش آب و هواي	خوش‌آب‌وهواي
آب و هوايي	آب‌وهوايي
خوش آب و هوا	خوش‌آب‌وهوا
پرت و پلا	پرت‌وپلا
تمام و كمال	تمام‌وكمال
دخل و تصرف	دخل‌وتصرف
ساخت و ساز	ساخت‌وساز
ساخت و سازها	ساخت‌وسازها
ساخت و سازهاي	ساخت‌وسازهاي
ساخت و سازهايي	ساخت‌وسازهايي
ساخت و پاخت	ساخت‌وپاخت
بريز و بپاش	بريزوبپاش