зъсЕг	зъс²Ег
Дсхй²хЕ	Дсхй хЕ
ЦсдФА	ЦсфФА
ЦсдФАМй	ЦсфФАМй
снД░ФМ	снД²░ФМ
░яФЕЕгМ	░яФЕ²ЕгМ
ФМ▌░МЕгМ	ФМ▌░М²ЕгМ
ЦФгщчйДгЦЕ	ЦФгщчй²ДгЦЕ
сгрЦгДЕгМ	сгрЦгД²ЕгМ
гсй²хЕ	гсй хЕ
ьямЕгМ	ьям²ЕгМ
мгАМъЕ	мгАМ²ъЕ
ягЕЕгМ	ягЕ²ЕгМ
осй░гЕЕгМ	осй░гЕ²ЕгМ
гМД²ъЕ	гМДъЕ
сМгсйЕгМ	сМгсй²ЕгМ
оМо░гЕЕгМ	оМо░гЕ²ЕгМ
яФтДщъягД	яФтД²щъягД
ЕЦМДьФя	ЕЦМД²ьФя
огДт░гЕЕг	огДт░гЕ²Ег
Фгр	Ф гр
ого░гЕЕгМ	ого░гЕ²ЕгМ
ЕМ█░ФДЕ	ЕМ█²░ФДЕ
лЕгД░яоМ	лЕгД²░яоМ
яФтДщъяМ	яФтД²щъяМ
ЦМйФгД	ЦМ²йФгД
гДсгДЕгМ	гДсгД²ЕгМ
йЦоДЕг	йЦоД²Ег
ячгхйЕгМ	ячгхй²ЕгМ
осйЕгМ	осй²ЕгМ
ЕЦ█ДгДъЕ	ЕЦ█ДгД ъЕ
йАгтЕгМ	йАгт²ЕгМ
░яФЕЕг	░яФЕ²Ег
бД²ЕгММ	бДЕгММ
бД²ъЕ	бДъЕ
ЦМ░Мяо	ЦМ²░Мяо
ЕМ█ъогЦ	ЕМ█²ъогЦ
ъФЕЕгМ	ъФЕ²ЕгМ
огДт░гЕЕгМ	огДт░гЕ²ЕгМ
хгт░гЕЕгМ	хгт░гЕ²ЕгМ
ФДМр	Ф ДМр
тМяФ	тМя Ф
ДМсй²хАъЕ	ДМсй хАъЕ
щМАЦсгрМ	щМАЦ²сгрМ
сМгсй░пгяМ	сМгсй²░пгяМ
гМД²лг	гМДлг
нМгхгДЕг	нМгхгД²Ег
гсй²хя	гсй хя
уящДыя	уящ²Дыя
ляМгДЕгМ	ляМгД²ЕгМ
Ф│с	Ф │с
ЦМ░щй	ЦМ²░щй
│ястЕгМ	│яст²ЕгМ
ЕМ█Мъ	ЕМ█²Мъ
ягхягМ	яг хягМ
Ф│яФят	Ф │яФят
ЕЦМДъЕ	ЕЦМД²ъЕ
осй░гЕЕг	осй░гЕ²Ег
ФлФоогяо	ФлФо огяо
ояхяЦМ	оя хя ЦМ
ъгЦАге	ъгЦАгП
ФбЦо	Ф бЦо
ФхягМ	Ф хягМ
гМДуФяй	гМД²уФяй
ФмйМ	Ф мйМ
хгр░тй²хЕ	хгр░тй хЕ
ЦДмуяхЕ	ЦДмуя хЕ
ФДМЦ	Ф ДМЦ
гсй┌	гсй ║
ФйФрМз	Ф йФрМз
Фг░я	Ф г░я
Фхзо	Ф хзо
тЕяМФяЦгЕ	тЕяМФя ЦгЕ
оАгАй²хя	оАгАй хя
ЕгФ	Ег Ф
оФогя	оФогя
ЦзяФщйяМД	ЦзяФщ²йяМД
ФЦг	Ф Цг
ЦнгАщй²хг	ЦнгАщй хг
сгнйЕгДо	сгнйЕ²гДо
хЕ²Дыя	хЕ Дыя
грйгяМн	гр йгяМн
ъяоЕ²гсй	ъяоЕ гсй
ЦФжз░МяМ	ЦФжз²░МяМ
ЦмМьЕгМ	ЦмМь²ЕгМ
Фс│с	Ф с│с
Фгсй	Ф гсй
ЦмМьрМсй	ЦмМь рМсй
хЕ²гМД	хЕ гМД
ФмъЦ	Ф мъЦ
ФЕЦЕ	Ф ЕЦЕ
гМД²гсй	гМД гсй
хоМДФсМАЕ	хоМД²ФсМАЕ
грхмк	гр хмк
оясьм	оя сьм
ояйЕягД	оя йЕягД
зАМ²зАМЕ²гАсАгЦ	зАМ зАМЕ²гАсАгЦ
лЦЕФяМнФгЕ	лЦЕФяМ²нФгЕ
бДЕЦЕ	бД²ЕЦЕ
ФАпг	Ф Апг
Фого░гЕ	Ф ого░гЕ
ФоМ░я	Ф оМ░я
оярЦгД	оя рЦгД
гФЦМ	гФ ЦМ
ояЕЦгД	оя ЕЦгД
ЦФяохмк	ЦФяо хмк
ЦкАге	ЦкАгП
яФсгФЦсйтгягД	яФсг Ф ЦсйтгягД
ФгЦг	Ф гЦг
гртзхЕ	гр тзхЕ
йчяМхге	йчяМхгП
мсМД²зАМЕ²гАсАгЦ	мсМД зАМЕ²гАсАгЦ
зАЬгЦЕ	зАЬгЦЕ
Фгчзге	ФгчзгП
ФлФоДогяо	ФлФо Догяо
ФйяхМй	Ф йяхМй
ояЦФгяоЦтгхЕ	оя ЦФгяо ЦтгхЕ
ояЦсгхчгй	оя Цсгхчгй
ФДФлФгДгД	Ф ДФлФгДгД
ЦзЦФАге	ЦзЦФАгП
гсйДгоЦгоЕ	гсйДго ЦгоЕ
гсй²Ф	гсй Ф
гярт░пгяМ	гярт²░пгяМ
оялЕгД	оя лЕгД
тнуМй²мчФчМ	тнуМй мчФчМ
│яст░яМ	│яст²░яМ
гуАге	гуАгП
ФгДогЦ	Ф гДогЦ
оясй²хгто	оясй хгто
бЦоЕ²гсй	бЦоЕ гсй
йлоМоДыянФгсйЕ	йлоМоДыя нФгсйЕ
грбДЕг	гр бДЕг
█Мсй┌	█Мсй ║
ояЦямАЕ	оя ЦямАЕ
ФМъМ	Ф МъМ
ояхяогяо	оя хя огяо
ЦФяогсйщгоЕ	ЦФяо гсйщгоЕ
щялгЦнФгсйЕ	щялгЦ²нФгсйЕ
грДгмМЕ	гр ДгмМЕ
грАмгы	гр Амгы
ФхоФД	Ф хоФД
ФбЦФрт	Ф бЦФрт
ътФяФ	ътФя Ф
ФшМя	Ф шМя
Ф│г	Ф │г
грЕЦЕ	гр ЕЦЕ
ФтЕясгрМ	Ф тЕясгрМ
ДФхй²хЕ	ДФхй хЕ
ФчйМъЕ	ФчйМ²ъЕ
ФЕМ█	Ф ЕМ█
хгМохЕ	хгМо хЕ
ЕсйДоъЕ	ЕсйДо ъЕ
ФхгйФлЕ	Ф хг йФлЕ
хмк²хЕ	хмк хЕ
яФоя	яФ оя
ноЦй²хЕ	ноЦй хЕ
гнМяге	гнМягП
оятзхЕ	оя тзхЕ
сМгсй²нгялМ	сМгсй нгялМ
ъЕ²хЕ	ъЕ хЕ
ътФягясгА	ътФя гясгА
Дыя░ящйД	Дыя ░ящйД
ФЦргМгМ	Ф ЦргМгМ
нФгЕоогтй	нФгЕо огтй
грЕЦгД	гр ЕЦгД
ыгЕяге	ыгЕягП
оятягМь	оя тягМь
оящуА	оя щуА
ФлЕй	Ф лЕй
ФгДйчгА	Ф гДйчгА
хФо┌	хФо ║
Фъгя	Ф ъгя
ФлФоогтйЕ	ФлФо огтйЕ
чгДФД²гсгсМ	чгДФД гсгсМ
ФяФМ	Ф яФМ
бДлгъЕ	бДлг ъЕ
бняЦгоЕ	бня ЦгоЕ
бягхтям	бяг хтям
бягугояЕ	бяг угояЕ
бшгръяоЕ	бшгр ъяоЕ
б░ЕМЕг	б░ЕМ²Ег
бЦоФ	бЦо Ф
бДмжяй	бД мжяй
бД²мжяй	бД мжяй
бДЕггр	бДЕг гр
бДЕгхЕ	бДЕг хЕ
бДЕгоя	бДЕг оя
бДЕгЦМ	бДЕг ЦМ
бМггМД	бМг гМД
гмйягЦгхЕ	гмйягЦг хЕ
грбх	гр бх
грбкгя	гр бкгя
грбДгД	гр бДгД
грбД█Е	гр бД█Е
грбДъЕ	гр бДъЕ
гргйЦгЦ	гр гйЦгЦ
грглягМ	гр глягМ
гргсй	гр гсй
гр²²гсй	гр гсй
гргщяго	гр гщяго
гргЦъгДгй	гр гЦъгДгй
гргДлгЦ	гр гДлгЦ
гргДчАгх	гр гДчАгх
гргМягД	гр гМягД
грхяясМ	гр хяясМ
грхЕ	гр хЕ
гр│гМгД	гр │гМгД
гр│нт	гр │нт
гр│яогнй	гр │яогнй
гр│тй	гр │тй
грйяс	гр йяс
грйуФМх	гр йуФМх
грйАФМрМФД	гр йАФМрМФД
грйЕягД	гр йЕягД
грлДхЕ	гр лДхЕ
грлД░	гр лД░
гр█До	гр █До
гр█Е	гр █Е
грмоФо	гр моФо
грмжФя	гр мжФя
грмч	гр мч
грмчФч	гр мчФч
грмъЦ	гр мъЦ
грнгДФгоЕ	гр нгДФгоЕ
грнгДЕ	гр нгДЕ
грноЦгй	гр ноЦгй
грноЦй	гр ноЦй
грнФгх	гр нФгх
грогДт░гЕ	гр огДт░гЕ
гроя	гр оя
гроФсйгД	гр оФсйгД
гроМ░я	гр оМ░я
гряг	гр яг
грягЕ	гр ягЕ
грягМ	гр ягМ
грясгДЕ	гр ясгДЕ
грясМо░М	гр ясМо░М
гряФрДгЦЕ	гр яФрДгЦЕ
гряФМ	гр яФМ
гррхгД	гр рхгД
гррЦгД	гр рЦгД
гррДо░М	гр рДо░М
грсгзй	гр сгзй
грсьм	гр сьм
грсД░	гр сД░
грсФММ	гр сФММ
грсЕ	гр сЕ
гртой	гр той
гртяъй	гр тяъй
гртъА	гр тъА
гртЦг	гр тЦг
гртЦФА	гр тЦФА
грумхй	гр умхй
грщМАЦ	гр щМАЦ
грчхА	гр чхА
грчягфй	гр чягфй
грчсЦй	гр чсЦй
грчФгДМД	гр чФгДМД
гръгя	гр ъгя
гръгятДгсгД	гр ъгятДгсгД
гръгяЕгМ	гр ъгяЕгМ
гръйгх	гр ъйгх
грълг	гр ълг
грътФя	гр ътФя
грътФяЕгМ	гр ътФяЕгМ
гр░птй	гр ░птй
грЦг	гр Цг
грЦлЦФзЕ	гр ЦлЦФзЕ
грЦмА	гр ЦмА
грЦойМ	гр ЦойМ
грЦяоЦ	гр ЦяоЦ
грЦсгфА	гр ЦсгфА
грЦтъАгй	гр ЦтъАгй
грЦчяягй	гр Цчяягй
грЦДгхз	гр ЦДгхз
грЦДъя	гр ЦДъя
грЦФго	гр ЦФго
грЦФгяо	гр ЦФгяо
грЦЕЦйяМД	гр ЦЕЦ²йяМД
грДЦгМт	гр ДЦгМт
грДФз	гр ДФз
грМъоМ░я	гр МъоМ░я
гсй╨МзДМ	 гсй ╨ МзДМ 
гсйгДогяорДо░М	гсйгДогяо рДо░М
гсй²хгМо	гсй хгМо
гсй²хоФД	гсй хоФД
гсй²хоМД	гсй хоМД
гсй²хягМ	гсй хягМ
гсй²хянМ	гсй хянМ
гсй²хсМгя	гсй хсМгя
гсй²х░ФММЦ	гсй х░ФММЦ
гсй²хДгхягМД	гсй хДгхягМД
гсй²хМД	гсй хМД
гсй²мйМ	гсй мйМ
гсймжгяЦМ	гсймжгя ЦМ
гсй²ногФДо	гсй ногФДо
гсй²нФо	гсй нФо
гсй²тЦг	гсй тЦг
гсйъЕ	гсй ъЕ
гсйДгочсЦй	гсйДго чсЦй
гсй²МзДМ	гсй МзДМ
гсй²МъМ	гсй МъМ
гыЕгяДыяЦМ	гыЕгяДыя ЦМ
гыЕгяДыяДЦФоЕ	гыЕгяДыя ДЦФоЕ
гзйхгяуАгмМй	гзйхгя уАгмМй
г░яхЕ	г░я хЕ
г░я█ДМД	г░я █ДМД
г░яоя	г░я оя
г░яъсМ	г░я ъсМ
гЦг²²гсй	гЦг гсй
гДхгтй²сяЦгМЕ	гДхгтй сяЦгМЕ
гДйчгЦлФММ	гДйчгЦ²лФММ
гФхягМ	гФ хягМ
гФхягМД	гФ хя гМД
гФъЕ	гФ ъЕ
гФ░щй	гФ ░щй
гФ²²ЦМ	гФ ЦМ
гЕЦМй²хМтйяМ	гЕЦМй хМтйяМ
гМлгоЦМ	гМлго ЦМ
гМД²рЦМДЕ	гМД рЦМДЕ
гМД²ъгя	гМД ъгя
гМД²ъйгх	гМД ъйгх
хгбДЕг	хг бДЕг
хггясгА	хг гясгА
хггФ	хг гФ
хгхгрМ	хг хгрМ
хгоФ	хг оФ
хгяЦМ	хгя ЦМ
хгръяоЦ	хгр ъяоЦ
хгрМЕгМЦгД	хгрМ²ЕгМЦгД
хгто┌	хгто ║
хгчязАМЕ	хгчя зАМЕ
хгъЦъ	хг ъЦъ
хгАгЦМ	хгАг ЦМ
хгАгФ	хгАг Ф
хгМогМД	хгМо гМД
хгМохягМ	хгМо хягМ
хгМох░ФМЦ	хгМо х░ФМЦ
хгМооя	хгМо оя
хгМоФ	хгМо Ф
хгМоМъ	хгМо Мъ
хмк²хя	хмк хя
хмк²нФгЕМЦ	хмк нФгЕМЦ
хмк²нФо	хмк нФо
хоДЕгМ	хоД²ЕгМ
хоДМсй	хо ДМсй
хягМ²гМДъЕ	хягМ гМДъЕ
хячягяЦМ	хячягя ЦМ
хя░ргянФгЕо	хя░ргя нФгЕо
хяМгсй	хЕ яМгсй
хуоФяягМ	хЕ уоФя ягМ
хзжМ²гр	хзжМ гр
хДыяЦМ	хЕ Дыя ЦМ
хДыяДЦМ	хЕ Дыя ДЦМ
хФоДоъЕ	хФоДо ъЕ
хФоДоФ	хФоДо Ф
хЕ²гмъгЦ	хЕ гмъгЦ
хЕ²гЦгЦ	хЕ гЦгЦ
хЕ²гДогрЕ	хЕ гДогрЕ
хЕ²гФ	хЕ гФ
хЕ²оАМА	хЕ оАМА
хЕ²ся	хЕ ся
хЕ²той	хЕ той
хЕ²зхгяй	хЕ зхгяй
хЕ²щчМЕгД	хЕ щчМЕгД
хЕъгя	хЕ ъгя
хЕ²Амгы	хЕ Амгы
хЕЦягЕ	хЕ ЕЦягЕ
хЕ²ЦзяФщ	хЕ ЦзяФщ
хЕ²ФАгМй	хЕ ФАгМй
хЕ²Ея	хЕ Ея
хМ²бД²ъЕ	хМ²бДъЕ
хМйгАЦчос	хМй²гАЦчос
хМй²зАМЕЦ²гАсАгЦ	хМй зАМЕЦ²гАсАгЦ
хМтйягр	хМтйя гр
хМтйяхЕ	хМтйя хЕ
хМзй²хг	хМзй хг
│яогнй²хЕ	│яогнй хЕ
│яЦМ	│я ЦМ
│ДлсгАЕ	│Дл²сгАЕ
│ФяФхгмжФяяФсгМ	│Фя Ф хг мжФя яФсгМ
йггр	йг гр
йггМД	йг гМД
йгйгяМн	йг йгяМн
йгкМяЦМ	йгкМя ЦМ
йг█Е	йг █Е
йгяМнД░гяМ	йгяМн²Д░гяМ
йгрЦгД	йг рЦгД
йгъМоЦМ	йгъМо ЦМ
йлоМоДыягсйгД	йлоМоДыя гсйгД
йлоМоДыянФгДоЕ	йлоМоДыя нФгДоЕ
йояМл²хЕ	йояМл хЕ
йяхМй²хгМо	йяхМй хгМо
йяхМй²хЕ	йяхМй хЕ
йзогойъ	йзого йъ
йшММячМЦй	йшММя чМЦй
йшММяЦМ	йшММя ЦМ
йъягяЦМ	йъягя ЦМ
йД²бягЦМ	йД бягЦМ
йДЕгхЕ	йДЕг хЕ
йДЕгоя	йДЕг оя
йФАМохяДгЦЕ	йФАМо хяДгЦЕ
йФАМоЦМ	йФАМо ЦМ
лгъЕ	лг ъЕ
лАФЦМ	лАФ ЦМ
лЦзМй²хЕ	лЦзМй хЕ
лЕй²хг	лЕй хг
лЕй²хЕ	лЕй хЕ
лЕй░МяМ	лЕй²░МяМ
█яхМЕгМ	█яхМ²ЕгМ
█ьФяЦМ	█ьФя ЦМ
мгАгъЕ	мгАг ъЕ
мйЦге	мйЦгП
моМк²хЕ	моМк хЕ
мяъй²хЕ	мяъй хЕ
мжФяоя	мжФя оя
мчМчй²хг	мчМчй хг
мчМчй²хЕ	мчМчй хЕ
мчМчй²нФо	мчМчй нФо
мчМчй²Мъ	мчМчй Мъ
мъФЦй²хя	мъФЦй хя
мъФЦй²хЕ	мъФЦй хЕ
нгДЕЕгМ	нгДЕ²ЕгМ
нхяого	нхя ого
ноЦй²мжяй	ноЦй мжяй
нАгщй²хЕ	нАгщй хЕ
нФгЕДоогтй	нФгЕДо огтй
нФогр	нФо гр
нФооя	нФо оя
нФоягхЕ	нФо яг хЕ
нФоягжМ	нФо ягжМ
огоъЕ	ого ъЕ
огоФ	ого Ф
огяо┌	огяо ║
огятоД	огя тоД
огяДоъЕ	огяДо ъЕ
огяДоФ	огяДо Ф
огтй²хЕ	огтй хЕ
оябх	оя бх
оябняМД	оя бняМД
оябсйгДЕ	оя бсйгДЕ
оябАЦгД	оя бАЦгД
оябДЕг	оя бДЕг
оягхйог	оя гхйог
оягйгч	оя гйгч
оягсйгД	оя гсйгД
оягсАгЦ	оя гсАгЦ
оягщшгДсйгД	оя гщшгДсйгД
оягЦяМъг	оя гЦяМъг
оягДйнгх	оя гДйнгх
оягДйыгя	оя гДйыгя
оягДлгЦ	оя гДлгЦ
оягДоМтЕ	оя гДоМтЕ
оягД░АсйгД	оя гД░АсйгД
оягФгня	оя гФгня
оягФгМА	оя гФгМА
оягМгЦ	оя гМгЦ
оягМлго	оя гМлго
ояхгрМ	оя хгрМ
ояхянМ	оя хянМ
ояхя░ящй	оя хя ░ящй
ояхзжМ	оя хзжМ
оя│тй	оя │тй
оя│М█	оя │М█
ояйфгйя	оя йфгйя
ояйхуяЕ	оя йхуяЕ
ояйяъМх	оя йяъМх
ояйзММД	оя йзММД
ояйАгт	оя йАгт
ояйЦгЦМ	оя йЦгЦМ
ояйЦяМДгй	оя йЦяМДгй
ояйФАМо	оя йФАМо
ояйЕМЕ	оя йЕМЕ
ояйМЦ	оя йМЦ
оялоФА	оя лоФА
оялАсгй	оя лАсгй
оялДФх	оя лДФх
оялФгх	оя лФгх
оялФгЦз	оя лФгЦз
оя█тЦ	оя █тЦ
оя█Егя	оя █Егя
оямоМ	оя моМ
оямяъй	оя мяъй
оянгял	оя нгял
оянгДФгоЕ	оя нгДФгоЕ
ояноЦй	оя ноЦй
оянМгхгД	оя нМгхгД
ояогонФгсй	оя огонФгсй
ояогДт░гЕ	оя огДт░гЕ
ояоялЕ	оя оялЕ
ояояФД	оя ояФД
ояоДМгМ	оя оДМгМ
ояоМогя	оя оМогя
ояоМФгД	оя оМФгД
ояпМА	оя пМА
ояягхьЕ	оя ягхьЕ
ояягоМФ	оя ягоМФ
ояягЕ	оя ягЕ
ояягМ	оя ягМ
ояяФрДгЦЕ	оя яФрДгЦЕ
оясгнй	оя сгнй
оясгрЦгД	оя сгрЦгД
оясгзй	оя сгзй
оясгАД	оя сгАД
оясгАЕгМ	оя сгА²ЕгМ
оясй²хЕ	оясй хЕ
оясяМгА	оя сяМгА
оясъФй	оя съФй
оясЦй	оя сЦй
оясМсйЦ	оя сМсйЦ
оясМДЦг	оя сМДЦг
оясМДЦгМ	оя сМДЦгМ
оятхъЕ	оя тхъЕ
оятям	оя тям
оятЦгА	оя тЦгА
оятФягМ	оя тФягМ
оятЕясйгД	оя тЕясйгД
оятЕяЕгМ	оя тЕяЕгМ
оязгАЦ	оя згАЦ
оязягч	оя зягч
оязяж	оя зяж
оязуя	оя зуя
оязАЦ	оя зАЦ
ояшях	оя шях
ояшМя	оя шМя
оящгуАЕ	оя щгуАЕ
оящжгМ	оя щжгМ
оячябД	оя чябД
оячяД	оя чяД
оячФгДМД	оя чФгДМД
ояъАгс	оя ъАгс
ояъЦМсМФД	оя ъЦМсМФД
оя░яот	оя ░яот
оя░яФЕ	оя ░яФЕ
оя░ФтЕ	оя ░ФтЕ
оя░ФтМ	оя ░ФтМ
ояАМ░	оя АМ░
ояЦйД	оя ЦйД
ояЦлАс	оя ЦлАс
ояЦлЦФзЕ	оя ЦлЦФзЕ
ояЦмМь	оя ЦмМь
ояЦой	оя Цой
ояЦоясЕ	оя ЦоясЕ
ояЦягмА	оя ЦягмА
ояЦягсЦ	оя ЦягсЦ
ояЦяър	оя Цяър
ояЦсгхчЕ	оя ЦсгхчЕ
ояЦсло	оя Цсло
ояЦугмхЕ	оя ЦугмхЕ
ояЦДрА	оя ЦДрА
ояЦФжФз	оя ЦФжФз
ояЦФчз	оя ЦФчз
ояЦЕАй	оя ЦЕАй
оя²²ЦМ	ояЦМ
ояЦМогД	оя ЦМогД
ояДгЦЕ	оя ДгЦЕ
ояДнсйМД	оя ДнсйМД
ояДыгЦ	оя ДыгЦ
ояДчт	оя Дчт
ояДЦгМт	оя ДЦгМт
ояДМгщйЕ	оя ДМгщйЕ
ояФярт░гЕ	оя Фярт░гЕ
ояФчй	оя Фчй
ояЕямгА	оя Ея мгА
ояЕщйЕ	оя ЕщйЕ
ояЕМгй	оя ЕМгй
ояЕМ█	оя ЕМ█
осй²ногсй	осй ногсй
осй²тЦг	осй тЦг
осйФяъгялАсЕ	осйФя ъгя лАсЕ
оФхгрМ	оФ хгрМ
оФйД	оФ йД
оФягр	оФя гр
оФягс	оФ ягс
оФАй²хя	оФАй хя
оФАй²хягМ	оФАй хягМ
оФАй²хЕ	оФАй хЕ
оФАйтЕяЕгМ	оФАй²тЕяЕгМ
оФАй²Мг	оФАй Мг
оМоъЕ	оМо ъЕ
оМ░яхЕ	оМ░я хЕ
оМ░яоя	оМ░я оя
оМ░яЦМ	оМ░я ЦМ
оМ░яДЦМ	оМ░я ДЦМ
оМФсгАгяЦЕгля	оМФсгАгя ЦЕгля
яггогЦЕ	яг гогЦЕ
яггягфЕ	яг гягфЕ
яггр	яг гр
яггзАгЦ	яг гзАгЦ
яггДйнгх	яг гДйнгх
яггДлгЦ	яг гДлгЦ
ягхоФД	яг хоФД
ягхяясМ	яг хяясМ
ягхМгД	яг хМгД
яг│тй	яг │тй
яг│Мог	яг │Мог
ягймй	яг ймй
ягйяъ	яг йяъ
ягйзММД	яг йзММД
ягйшММя	яг йшММя
ягйЦгтг	яг йЦгтг
яглЦз	яг лЦз
яглЕй	яг лЕй
ягмщы	яг мщы
ягогяДо	яг огяДо
ягогтй	яг огтй
ягогтйЕ	яг огтйЕ
ягоясй	яг оясй
ягояуАгмМй	яг оя уАгмМй
ягоДхгА	яг оДхгА
ягоФсй	яг оФсй
ягоМоЕ	яг оМоЕ
ягтяФз	яг тяФз
ягщягЕЦ	яг щягЕЦ
ягщАр	яг щАр
ягчгхА	яг чгхА
ягчхФА	яг чхФА
ягъДгя	яг ъДгя
яг░ящйЕ	яг ░ящйЕ
ягЦйФлЕ	яг ЦйФлЕ
ягЦтну	яг Цтну
ягЦьям	яг Цьям
ягЦФяо	яг ЦФяо
ягДогяДо	яг ДогяДо
ягДсхй	яг Дсхй
ягДчж	яг Дчж
ягДЦФоЕ	яг ДЦФоЕ
ягДМр	яг ДМр
ягФгогя	яг Фгогя
ялзй²хЕ	ялзй хЕ
яоЦМ	яо ЦМ
ясЦМй²тДгнйЕ	ясЦМй тДгнйЕ
ясФАног	ясФА ног
ясМоъЕ	ясМо ъЕ
яжгзАМЕ	яжг зАМЕ
яжгзАМЕ²гАсАгЦ	яжг зАМЕ²гАсАгЦ
ячгхй²хг	ячгхй хг
яъзй²нФгДоЕ	яъзй нФгДоЕ
яФгМй²хЕ	яФгМй хЕ
яФртДхЕ	яФр тДхЕ
роФ	ро Ф
ръЕ	р ъЕ
снй²хЕ	снй хЕ
сягр	ся гр
сяхяЦМ	ся хяЦМ
сяйФ	ся йФ
сяояДЦМ	ся ояДЦМ
сДй²хЕ	сДй хЕ
сЕтДхЕ	сЕ²тДхЕ
сМгсй²хЕ	сМгсй хЕ
то┌	то ║
тоФ	то Ф
тоЕгсй	тоЕ гсй
тяМзй²хЕ	тяМзй хЕ
тзя■░АтД	тзя ■░АтД
тъсй²хгргя	тъсй хгргя
т░щйМЕгМ	т░щйМ²ЕгМ
тДгнй²ногФДо	тДгнй ногФДо
тФо┌	тФо ║
тФоъЕ	тФо ъЕ
тФоФ	тФо Ф
угмх■░АтД	угмх ■░АтД
угояФ	угоя Ф
угояФгзАгЦ	угоя Ф гзАгЦ
угоч²зАМЕ²гАсАгЦ	угоч зАМЕ²гАсАгЦ
ухягФ	ухя гФ
умДЕЕгМ	умДЕ²ЕгМ
уящге	уящгП
жоМй²хг	жоМй хг
ьхМзй²хЕ	ьхМзй хЕ
ьящйя	ьящ²йя
зогАй²хЕ	зогАй хЕ
зАЦгФ	зАЦг Ф
зДгМй²хЕ	зДгМй хЕ
шМхй²мжяй	шМхй мжяй
щогясМФД	щоягсМФД
щялгЦнФгЕ	щялгЦ²нФгЕ
щямхнт	щям²хнт
щяоФхгмжФяяФсгМ	щяо Ф хг мжФя яФсгМ
щзгАМй²сМгсМ	щзгАМй сМгсМ
щъяДЦМ	щъя ДЦМ
чхА²гр	чхА гр
чягяоЕМЦ	чягя оЕМЦ
чягяЦМ²░Мяо	чягя ЦМ²░Мяо
чсЦй²хЕ	чсЦй хЕ
ъгяг░я	ъгя г░я
ъгяхЕ	ъгя хЕ
ъгянФо	ъгя нФо
ъгДй²хЕ	ъгДй хЕ
ъйгх■│МгЦ	ъйгх ■│МгЦ
ъяо┌	ъяо ║
ъяолЕгД	ъяо лЕгД
ъяоДоъЕ	ъяоДо ъЕ
ъяоДоФ	ъяоДо Ф
ътЦътЕгМ	ътЦът²ЕгМ
ътФябчгМ	ътФя бчгМ
ътФягялгз	ътФя гялгз
ътФяхягМ	ътФя хягМ
ътФяхтям	ътФя хЕ тям
ътФяйтъМА	ътФя йтъМА
ътФя█ДМД	ътФя █ДМД
ътФяоя	ътФя оя
ътФяьям	ътФя ьям
ътФяЦг	ътФя Цг
ътФяЦьям	ътФя Цьям
ътФяФхгмжФя	ътФя Ф хг мжФя
ътФяФхгмжФялДгх	ътФя Ф хг мжФя лДгх
ътФяФлДгхгД	ътФя Ф лДгхгД
ътФяФого░гЕЕгояЦФгяоЦтгхЕ	ътФя Ф ого░гЕ²Ег оя ЦФгяо ЦтгхЕ
ъДо┌	ъДо ║
ъДтЕг	ъДт²Ег
ъДДоФ	ъДДо Ф
ъДМоъЕ	ъДМо ъЕ
ъЕ²бД	ъЕ бД
ъЕ²гр	ъЕ гр
ъЕ²г░я	ъЕ г░я
ъЕ²гДсгД	ъЕ гДсгД
ъЕ²гМД	ъЕ гМД
ъЕ²хягМ	ъЕ хягМ
ъЕ²Цг	ъЕ Цг
░грняФлМ	░гр няФлМ
░ящйЕгДо	░ящйЕ²гДо
░щй²хЕ	░щй хЕ
░МАФММ	ъМАФММ
АпгхЕ	Апг хЕ
Цггр	Цг гр
ЦгДЦМ	Цг ДЦМ
ЦхйАгхЕ	ЦхйАг хЕ
Цкхй²хЕ	Цкхй хЕ
ЦлЦФзЕМ	ЦлЦФзЕ²М
ЦлМоФ	ЦлМо Ф
Цмхй²хЕ	Цмхй хЕ
ЦмхФхйяМД	ЦмхФх²йяМД
ЦпъФяхЕ	ЦпъФя хЕ
ЦпъФяоя	ЦпъФя оя
ЦпъФяояЦгоЕ	ЦпъФя оя ЦгоЕ
ЦпъФяьМ	ЦпъФя ьМ
ЦягхЕ	Цяг хЕ
ЦяхФьхЕ	ЦяхФь хЕ
ЦрхФяхЕ	ЦрхФя хЕ
ЦсйДогхЕ	ЦсйДог хЕ
ЦсйДохЕ	ЦсйДо хЕ
ЦсМмМй²хЕ	ЦсМмМй хЕ
ЦтЕФоДМсй	ЦтЕФо ДМсй
Цьгхчй²хг	Цьгхчй хг
Цзящй²хЕ	Цзящй хЕ
Цзящй²Мг	Цзящй Мг
Цчогяоя	Цчогя оя
Цчогяяг	Цчогя яг
ЦчогяЕсйЕ	Цчогя ЕсйЕ
ЦАй²хЕ	ЦАй хЕ
ЦФлФооя	ЦФлФо оя
ЦФяоЦзгЦАЕ	ЦФяо ЦзгЦАЕ
ЦФтЕгММ	ЦФт²ЕгММ
ЦФчзМй²нФо	ЦФчзМй нФо
ЦМ²хгМсй²хЕ	ЦМ²хгМсй хЕ
ЦМ²йФгДсй²хЕ	ЦМ²йФгДсй хЕ
ЦМ²тФоъЕ	ЦМ²тФо ъЕ
ЦМътМо	ЦМ²ътМо
ЦМ²ъДоъЕ	ЦМ²ъДо ъЕ
Дгягмй²то	Дгягмй то
Днсй²хЕ	Днсй хЕ
ДогяоФ	Догяо Ф
Дсхй²хг	Дсхй хг
ДыяЦД	Дыя ЦД
ДыяДЦМ	Дыя ДЦМ
Дщягр	Дщя гр
ДЦМйФгДЦ	ДЦМ²йФгДЦ
ДФяоМо	ДФя оМо
ДЕгМй²хЕ	ДЕгМй хЕ
ДМгрхЕ	ДМгр хЕ
ДМргМД	ДМр гМД
ДМрхг	ДМр хг
ДМрхЕ	ДМр хЕ
ДМроя	ДМр оя
ДМрЦМ	ДМр ЦМ
ДМсй┌	ДМсй ║
ДМсй²хг	ДМсй хг
ДМсй²хЕ	ДМсй хЕ
ДМсй²ъЕ	ДМсй ъЕ
ДМсй²Мг	ДМсй Мг
ФбфМД	Ф бфМД
Фбх	Ф бх
Фбкгя	Ф бкгя
ФбняМД	Ф бняМД
ФбоЦ	Ф боЦ
ФбягЦт	Ф бягЦт
ФбчгМ	Ф бчгМ
ФбЦгоЕ	Ф бЦгоЕ
ФбДгД	Ф бДгД
ФбД█Е	Ф бД█Е
ФбДЕг	Ф бДЕг
ФгхьгА	Ф гхьгА
ФглгрЕ	Ф глгрЕ
ФглйЦгзМ	Ф глйЦгзМ
ФглягМ	Ф глягМ
ФгмйягЦ	Ф гмйягЦ
Фгмсгс	Ф гмсгс
ФгмъгЦ	Ф гмъгЦ
ФгмФгА	Ф гмФгА
ФгнйАгщ	Ф гнйАгщ
ФгнйМгягй	Ф гнйМгягй
ФгнАгч	Ф гнАгч
ФгнАгчМ	Ф гнАгчМ
ФгогяЕ	Ф гогяЕ
ФгохМгй	Ф гохМгй
Фгпг	Ф гпг
ФгягфЕ	Ф гягфЕ
ФгягоЕ	Ф гягоЕ
Фгяйхгь	Ф гяйхгь
Фгяйхгьгй	Ф гяйхгьгй
ФгяоЦМ	Фгяо ЦМ
Фгярт	Ф гярт
ФгргМД	Ф гр гМД
ФгрьящМ	Ф гр ьящМ
Фгсгс	Ф гсгс
ФгсйногЦМ	Ф гсйногЦМ
Фгсйзого	Ф гсйзого
ФгсАгЦ	Ф гсАгЦ
ФгуАг	Ф гуАг
ФгуАгм	Ф гуАгм
ФгуФА	Ф гуФА
ФгьАгз	Ф гьАгз
ФгьАгзгй	Ф гьАгзгй
ФгыЕгя	Ф гыЕгя
Фгзйхгя	Ф гзйхгя
Фгзйягж	Ф гзйягж
ФгзЦгА	Ф гзЦгА
ФгщргМт	Ф гщргМт
ФгщрФо	Ф гщрФо
ФгчйугоМ	Ф гчйугоМ
ФгчогЦ	Ф гчогЦ
ФгчогЦгй	Ф гчогЦгй
ФгчзМй²хЕ	ФгчзМй хЕ
ФгъДФД	Ф гъДФД
ФгАхйЕ	Ф гАхйЕ
ФгЦгЦ	Ф гЦгЦ
ФгЦкгА	Ф гЦкгА
ФгЦъгД	Ф гЦъгД
ФгЦъгДгй	Ф гЦъгДгй
ФгЦАгъ	Ф гЦАгъ
ФгЦДМй	Ф гЦДМй
ФгЦФя	Ф гЦФя
ФгДйнгх	Ф гДйнгх
ФгДйчгАгй	Ф гДйчгАгй
ФгДогрЕ	Ф гДогрЕ
ФгДоМтЕ	Ф гДоМтЕ
ФгДсгД	Ф гДсгД
ФгДчАгх	Ф гДчАгх
ФгД░А	Ф гД░А
ФгФягч	Ф гФягч
ФгЕогщ	Ф гЕогщ
ФгМлго	Ф гМлго
ФгМсйгоЕ	Ф гМсйгоЕ
ФгМЦгД	Ф гМЦгД
ФгМДъ	Ф гМДъ
ФхгмжФяяФсгМ	Ф хг мжФя яФсгМ
Фхгр	Ф хгр
ФхгрМ	Ф хгрМ
Фхгтяъй	Ф хг тяъй
ФхгзДгМй	Ф хг зДгМй
ФхгАгняЕ	Ф хгАгняЕ
ФхгМо	Ф хгМо
Фх█Е	Ф х█Е
Фхмк	Ф хмк
Фхо	Ф хо
ФхоА	Ф хоА
ФхоМД	Ф хоМД
Фхягхя	Ф хягхя
Фхягсгс	Ф хя гсгс
ФхянМ	Ф хянМ
Фхяч	Ф хяч
ФхяДгЦЕ	Ф хяДгЦЕ
Фхря░	Ф хря░
ФхсМгяМ	Ф хсМгяМ
Фхтям	Ф хЕ тям
ФхзжМ	Ф хзжМ
ФхчМЕ	Ф хчМЕ
ФхЦФлх	Ф хЕ ЦФлх
ФхДгхягМД	Ф хДгхягМД
ФхДо	Ф хДо
ФхФолЕ	Ф хФолЕ
ФхМгД	Ф хМгД
ФхМсй	Ф хМсй
ФхМтйя	Ф хМтйя
ФхМД	Ф хМД
Ф│гсн	Ф │гсн
Ф│гММД	Ф │гММД
Ф│нт	Ф │нт
Ф│яогнй	Ф │яогнй
Ф│тй	Ф │тй
Ф│ДлгЕ	Ф │ДлгЕ
Ф│ДлЦ	Ф │ДлЦ
Ф│Мт	Ф │Мт
Фйгх	Ф йгх
ФйгяМн	Ф йгяМн
ФйгяМнМ	Ф йгяМнМ
ФйхгоА	Ф йхгоА
ФйляхЕ	Ф йляхЕ
ФйлЕМргй	Ф йлЕМргй
ФймчМч	Ф ймчМч
ФймчМчгй	Ф ймчМчгй
ФймФА	Ф ймФА
ФйоФМД	Ф йоФМД
ФйяйМх	Ф йяйМх
ФйтнМу	Ф йтнМу
ФйтъМА	Ф йтъМА
ФйуЦМЦ	Ф йуЦМЦ
ФйуФМх	Ф йуФМх
ФйуФМя	Ф йуФМя
ФйзгАМ	Ф йзгАМ
Фйзого	Ф йзого
ФйзогоМ	Ф йзогоМ
ФйзММД	Ф йзММД
ФйшММягй	Ф йшММягй
ФйщсМя	Ф йщсМя
ФйчгжгМ	Ф йчгжгМ
ФйъгЦА	Ф йъгЦА
ФйАгт	Ф йАгт
ФйАщД	Ф йАщД
ФйАФМрМФД	Ф йАФМрМФД
ФйАФМрМФДМ	Ф йАФМрМФДМ
ФйЦгЦ	Ф йЦгЦ
ФйДыМЦ	Ф йДыМЦ
ФйФгД	Ф йФгД
ФйФгДгММ	Ф йФгДгММ
ФйФлЕ	Ф йФлЕ
ФйФсь	Ф йФсь
ФйФсзЕ	Ф йФсзЕ
ФйФжМм	Ф йФжМм
ФйФАМо	Ф йФАМо
ФйЕМЕ	Ф йЕМЕ
ФйМЦ	Ф йМЦ
Фкгхй	Ф кгхй
ФлгАх	Ф лгАх
ФлгЦзЕ	Ф лгЦзЕ
ФлАФ░МяМ	Ф лАФ░МяМ
ФлФгх	Ф лФгх
ФлФгДгД	Ф лФгДгД
ФлЕгД	Ф лЕгД
Ф█тЦ	Ф █тЦ
Ф█░ФДЕ	Ф █░ФДЕ
Ф█До	Ф █До
Ф█ДМД	Ф █ДМД
Ф█ЕгяЦ	Ф █ЕгяЦ
Ф█ЕяЕ	Ф █ЕяЕ
Ф█МрМ	Ф █МрМ
ФмгА	Ф мгА
ФмгАг	Ф мгАг
ФмоФо	Ф моФо
Фмпщ	Ф мпщ
Фмящ	Ф мящ
ФмящЕ	Ф мящЕ
Фмяъй	Ф мяъй
ФмжФя	Ф мжФя
Фмщы	Ф мщы
Фмч	Ф мч
ФмчФч	Ф мчФч
ФмчФчМ	Ф мчФчМ
ФмъФЦй	Ф мъФЦй
ФмЦгМй	Ф мЦгМй
Фнгял	Ф нгял
ФнгялМ	Ф нгялМ
Фнгъ	Ф нгъ
ФнгДЦ	Ф нгДЦ
ФнгДФгоЕ	Ф нгДФгоЕ
ФнгДЕ	Ф нгДЕ
ФноЦгй	Ф ноЦгй
ФнАгуЕ	Ф нАгуЕ
ФнФх	Ф нФх
ФнФо	Ф нФо
ФнФот	Ф нФот
ФнФт	Ф нФт
ФнМАМ	Ф нМАМ
ФогоДгЦЕ	Ф огоДгЦЕ
ФогягфМ	Ф огягфМ
ФогягМ	Ф огягМ
ФогягММ	Ф огягММ
ФогДт	Ф огДт
ФогДт░гЕ	Ф огДт░гЕ
ФоягМД	Ф оя гМД
ФояхгяЕ	Ф ояхгяЕ
ФояйгяМн	Ф оя йгяМн
ФоянФгсй	Ф оянФгсй
Фояъ	Ф ояъ
ФояЦгД	Ф ояЦгД
ФояДйМлЕ	Ф ояДйМлЕ
ФояМгщй	Ф ояМгщй
ФоФхгяЕ	Ф оФхгяЕ
ФоФсй	Ф оФсй
ФоФАй	Ф оФАй
ФоМ░ягД	Ф оМ░ягД
ФоМД	Ф оМД
ФясЦ	Ф ясЦ
ФясФАЕ	Ф ясФАЕ
ФясФЦ	Ф ясФЦ
ФязгМй	Ф язгМй
Фя░	Ф я░
ФяД░	Ф яД░
ФяФохЕ	ФяФо хЕ
ФяФотъгМй	ФяФо тъгМй
ФяФрДгЦЕ	Ф яФрДгЦЕ
ФяФт	Ф яФт
ФрЦгДМ	Ф рЦгДМ
ФрЦМД	Ф рЦМД
ФрДо░М	Ф рДо░М
ФрМгД	Ф рМгД
ФсгрЦгД	Ф сгрЦгД
ФсгМя	Ф сгМя
ФсгМяЦяглз	Ф сгМя Цяглз
Фснй	Ф снй
ФсягДлгЦ	Ф сягДлгЦ
ФсяЦгМЕ	Ф сяЦгМЕ
ФсяМгА	Ф сяМгА
ФсщМо	Ф сщМо
ФсМгсМ	Ф сМгсМ
ФсМЦг	Ф сМЦг
ФсМДЦг	Ф сМДЦг
ФтгЕо	Ф тгЕо
ФтгМо	Ф тгМо
Фтх	Ф тх
ФтхъЕ	Ф тхъЕ
ФтнуМй	Ф тнуМй
ФтягМь	Ф тягМь
Фтяъй	Ф тяъй
ФтяФз	Ф тяФз
Фтт	Ф тт
ФттЦ	Ф ттЦ
ФтъА	Ф тъА
ФтЦг	Ф тЦг
ФтДгнй	Ф тДгнй
ФтФягМ	Ф тФягМ
ФтФЕя	Ф тФЕя
ФтМФЕ	Ф тМФЕ
Фугмх	Ф угмх
Фуог	Ф уог
ФуогМ	Ф уогМ
ФуоФямъЦ	Ф уоФя мъЦ
ФуФяй	Ф уФяй
ФжЦД	Ф жЦД
Фьхч	Ф ьхч
Фьям	Ф ьям
ФьМ	Ф ьМ
Фзпгх	Ф зпгх
Фзъс	Ф зъс
ФзАгчЕ	Ф зАгчЕ
ФзАЦ	Ф зАЦ
ФзАФЦ	Ф зАФЦ
ФзЦА	Ф зЦА
ФшяМх	Ф шяМх
ФщгжАгх	Ф щгжАгх
ФщяФт	Ф щяФт
ФщяЕД░	Ф щяЕД░
Фщтгя	Ф щтгя
ФщуА	Ф щуА
ФщзгАМй	Ф щзгАМй
Фщъя	Ф щъя
ФщАргй	Ф щАргй
ФщАсщЕ	Ф щАсщЕ
ФщДгФяМ	Ф щДгФяМ
ФщФч	Ф щФч
ФщМАЦ	Ф щМАЦ
ФчгхА	Ф чгхА
ФчгДФД	Ф чгДФД
ФчхА	Ф чхА
Фчй²хЕ	Фчй хЕ
Фчояй	Ф чояй
Фчягя	Ф чягя
ФчягязоЦ	Ф чягя зоЦ
ФчФгДМД	Ф чФгДМД
Фъгя░яогД	Ф ъгя░яогД
Фъгя░яогДМ	Ф ъгя░яогДМ
ФъгяЕгМ	Ф ъгяЕгМ
ФъгяМ	Ф ъгяМ
ФъгЕт	Ф ъгЕт
Фъйгх	Ф ъйгх
ФъсгДМ	Ф ъсгДМ
Фъсх	Ф ъсх
ФъсМ	Ф ъсМ
ФъА	Ф ъА
ФъЦгА	Ф ъЦгА
ФъЦъ	Ф ъЦъ
ФъДйяА	Ф ъДйяА
ФъФ█ъ	Ф ъФ█ъ
ФъМщяМ	Ф ъМщяМ
ФъМщМй	Ф ъМщМй
Ф░гр	Ф ░гр
Ф░гЕМ	Ф ░гЕМ
Ф░пгя	Ф ░пгя
Ф░я█Е	Ф ░я█Е
Ф░яФЕ	Ф ░яФЕ
Ф░ргят	Ф ░ргят
Ф░сйят	Ф ░сйят
Ф░щйЦ	Ф ░щйЦ
Ф░А	Ф ░А
Ф░ФгЕМ	Ф ░ФгЕМ
Ф░Фт	Ф ░Фт
ФАгрЦ	Ф АгрЦ
ФАгМй²хя	ФАгМй хя
ФАгМй²хЕ	ФАгМй хЕ
ФАхгс	Ф Ахгс
ФЦгоя	Ф Цгоя
ФЦгАМ	Ф ЦгАМ
ФЦгДДо	Ф ЦгДДо
ФЦкА	Ф ЦкА
ФЦлгргй	Ф Цлгргй
ФЦмА	Ф ЦмА
ФЦмЦо	Ф ЦмЦо
ФЦнгьх	Ф Цнгьх
ФЦогяъ	Ф Цогяъ
ФЦоМяМй	Ф ЦоМяМй
ФЦяхМгД	Ф ЦяхМгД
ФЦяо	Ф Цяо
ФЦяоЦ	Ф ЦяоЦ
ФЦсгфА	Ф ЦсгфА
ФЦсйгля	Ф Цсйгля
ФЦсйтгягД	Ф ЦсйтгягД
ФЦсъД	Ф ЦсъД
ФЦтгФяЕ	Ф ЦтгФяЕ
ФЦтну	Ф Цтну
ФЦтъАгй	Ф ЦтъАгй
ФЦьгхч	Ф Цьгхч
ФЦзгоД	Ф ЦзгоД
ФЦзоД	Ф ЦзоД
ФЦзящМ	Ф ЦзящМ
ФЦзАФЦ	Ф ЦзАФЦ
ФЦзЦгяМ	Ф ЦзЦгяМ
ФЦзДФМ	Ф ЦзДФМ
ФЦщгЕМЦ	Ф ЦщгЕМЦ
ФЦщЕФЦ	Ф ЦщЕФЦ
ФЦчгЦ	Ф ЦчгЦ
ФЦъгД	Ф ЦъгД
ФЦАгмыЕ	Ф ЦАгмыЕ
ФЦАМ	Ф ЦАМ
ФЦЦъД	Ф ЦЦъД
ФЦДгхз	Ф ЦДгхз
ФЦДьхч	Ф ЦДьхч
ФЦФго	Ф ЦФго
ФЦФлх	Ф ЦФлх
ФЦФяо	Ф ЦФяо
ФЦФссгй	Ф ЦФссгй
ФЦФсМчМ	Ф ЦФсМчМ
ФЦФжФз	Ф ЦФжФз
ФЦФчзМй	Ф ЦФчзМй
ФЦМ	Ф ЦМ
ФЦМогДМ	Ф ЦМогДМ
ФЦМргД	Ф ЦМргД
ФДгЦ	Ф ДгЦ
ФДгЦЕ	Ф ДгЦЕ
ФДйМлЕ	Ф ДйМлЕ
ФДмФЕ	Ф ДмФЕ
ФДсхй	ФДсхй
ФДтгД	Ф ДтгД
ФДыгяй	Ф Дыгяй
ФДыгЦ	Ф ДыгЦ
ФДыя	Ф Дыя
ФДыяхЕ	Ф Дыя хЕ
ФДыяМЕ	Ф ДыяМЕ
ФДчт	Ф Дчт
ФДчж	Ф Дчж
ФД░ЕогяМ	Ф Д░ЕогяМ
ФДЦгМт	Ф ДЦгМт
ФДЦМ	Ф ДЦМ
ФДФлФгД	Ф ДФлФгД
ФДФсгрМ	Ф ДФсгрМ
ФДФтйЕ	Ф ДФтйЕ
ФДФМсДоЕ	Ф ДФМсДоЕ
ФДМгрЕгМ	Ф ДМгрЕгМ
ФДМяФМ	Ф ДМяФМ
ФФлФо	Ф ФлФо
ФФргяй	Ф Фргяй
ФФчйМ	Ф ФчйМ
ФЕощ	Ф Еощ
ФЕрМДЕ	Ф ЕрМДЕ
ФЕтй	Ф Етй
ФЕщйЦ	Ф ЕщйЦ
ФЕЦгЕД░М	Ф ЕЦгЕД░М
ФЕЦягЕ	Ф ЕЦягЕ
ФЕЦъгягД	Ф ЕЦъгягД
ФЕЦъгяМ	Ф ЕЦъгяМ
ФЕЦМтЕ	Ф ЕЦМтЕ
ФЕДя	Ф ЕДя
ФЕДяМ	Ф ЕДяМ
ФЕД░гЦМ	Ф ЕД░гЦМ
ФЕФг	Ф ЕФг
ФЕФгММ	Ф ЕФгММ
ФЕМфй	Ф ЕМфй
Еггр	Ег гр
ЕгхягМ	Ег хягМ
ЕгогосйгД	Ег огосйгД
ЕгъЕ	Ег ъЕ
ЕогМй²хЕ	ЕогМй хЕ
ЕябД	Ея бД
ЕяуФяй	Ея уФяй
Еяъгя	Ея ъгя
Есй²хЕ	Есй хЕ
ЕсйДоФ	ЕсйДо Ф
Есй²Мг	Есй Мг
ЕЦ█ДгД²ъЕ	ЕЦ█ДгД ъЕ
ЕЦярЦгД	ЕЦ²ярЦгД
Мггр	Мг гр
МггМД	Мг гМД
МгмйМ	Мг мйМ
Мгоя	Мг оя
МъуоФ	Мъуо Ф
МъчоЦМ	Мъ²чоЦМ
МъЕргяФ	Мъ²Ергя Ф
МъМ²гр	МъМ гр